key	text	tooltip
#Loc;1;text/db/campaign_payload_ui_details__.loc		
campaign_payload_ui_details_description_add_mercenary_to_faction_pool	%1% (x%2%)	false
campaign_payload_ui_details_description_add_mercenary_to_province_pool	{{tr:add_mercenary_to_faction_pool}} %1% (x%2%)	false
campaign_payload_ui_details_description_add_province_development_point		false
campaign_payload_ui_details_description_add_unit	Add unit: %1% (x%2%)	false
campaign_payload_ui_details_description_ambition_change		false
campaign_payload_ui_details_description_assign_character_to_post	Office appointed: %1%, %2%	false
campaign_payload_ui_details_description_character_experience_change	Bonus experience: %1% for %2%	false
campaign_payload_ui_details_description_damage_buildings	Buildings damaged	false
campaign_payload_ui_details_description_damage_buildings_home_region	Buildings damaged	false
campaign_payload_ui_details_description_damage_character	Character damaged	false
campaign_payload_ui_details_description_demolish_building_chain	Building demolished	false
campaign_payload_ui_details_description_diplomatic_attitude_change	Diplomatic relations: %+1% with %2%	false
campaign_payload_ui_details_description_dummy_ToL_points_bonus	This settlement will generate additional Victory Points for a duration	false
campaign_payload_ui_details_description_dummy_ToL_points_bonus_explainer	This bonus will be lost if the settlement's owner changes	false
campaign_payload_ui_details_description_dummy_ariel_spawns	Legendary Hero Recruited: Ariel	false
campaign_payload_ui_details_description_dummy_blank		false
campaign_payload_ui_details_description_dummy_confederate_aquitaine	Confederation formed with Aquitaine	false
campaign_payload_ui_details_description_dummy_confederate_artois	Confederation formed with Artois	false
campaign_payload_ui_details_description_dummy_confederate_averland	Confederation formed with Averland	false
campaign_payload_ui_details_description_dummy_confederate_bastonne	Confederation formed with Bastonne	false
campaign_payload_ui_details_description_dummy_confederate_bordeleaux	Confederation formed with Bordeleaux Errant	false
campaign_payload_ui_details_description_dummy_confederate_bretonnia	Confederation formed with Bretonnia	false
campaign_payload_ui_details_description_dummy_confederate_carcassonne	Confederation formed with Carcassonne	false
campaign_payload_ui_details_description_dummy_confederate_faction_argwylon	You will be given the opportunity to confederate with the faction of Argwylon	false
campaign_payload_ui_details_description_dummy_confederate_faction_bowmen	You will be given the opportunity to confederate with the Bowmen of Oreon	false
campaign_payload_ui_details_description_dummy_confederate_faction_drycha	You will be given the opportunity to confederate with Drycha's faction	false
campaign_payload_ui_details_description_dummy_confederate_faction_karak_hirn	You will be given the opportunity to confederate with Karak Hirn	false
campaign_payload_ui_details_description_dummy_confederate_faction_karond_kar	You will be given the opportunity to confederate with Karond Kar	false
campaign_payload_ui_details_description_dummy_confederate_faction_laurelorn	You will be given the opportunity to confederate with the faction of Laurelorn Forest	false
campaign_payload_ui_details_description_dummy_confederate_faction_shanlin	You will be given the opportunity to confederate with the faction of Spirits of Shanlin	false
campaign_payload_ui_details_description_dummy_confederate_faction_sisters	You will be given the opportunity to confederate with the Sisters of Twilight	false
campaign_payload_ui_details_description_dummy_confederate_faction_talsyn	You will be given the opportunity to confederate with the faction of Talsyn	false
campaign_payload_ui_details_description_dummy_confederate_faction_torgovann	You will be given the opportunity to confederate with the faction of Torgovann	false
campaign_payload_ui_details_description_dummy_confederate_faction_wydrioth	You will be given the opportunity to confederate with the faction of Wydrioth	false
campaign_payload_ui_details_description_dummy_confederate_greenskin_boss_defeated	Confederation formed with this Warboss' faction	false
campaign_payload_ui_details_description_dummy_confederate_hochland	Confederation formed with Hochland	false
campaign_payload_ui_details_description_dummy_confederate_lyonesse	Confederation formed with Lyonesse	false
campaign_payload_ui_details_description_dummy_confederate_middenland	Confederation formed with Middenland	false
campaign_payload_ui_details_description_dummy_confederate_nordland	Confederation formed with Nordland	false
campaign_payload_ui_details_description_dummy_confederate_norsca_chieftan_defeated	Confederation formed with the chieftain's tribe	false
campaign_payload_ui_details_description_dummy_confederate_option_wh2_main_dwf_spine_of_sotek_dwarfs	You will gain the opportunity to confederate Spine of Sotek Dwarfs	false
campaign_payload_ui_details_description_dummy_confederate_option_wh2_main_hef_caledor	You will gain the opportunity to confederate Caledor	false
campaign_payload_ui_details_description_dummy_confederate_option_wh_main_dwf_karak_azul	You will gain the opportunity to confederate Karak Azul	false
campaign_payload_ui_details_description_dummy_confederate_ostermark	Confederation formed with Ostermark	false
campaign_payload_ui_details_description_dummy_confederate_ostland	Confederation formed with Ostland	false
campaign_payload_ui_details_description_dummy_confederate_parravon	Confederation formed with Parravon	false
campaign_payload_ui_details_description_dummy_confederate_reikland	Confederation formed with Reikland	false
campaign_payload_ui_details_description_dummy_confederate_stirland	Confederation formed with Stirland	false
campaign_payload_ui_details_description_dummy_confederate_talabecland	Confederation formed with Talabecland	false
campaign_payload_ui_details_description_dummy_confederate_wh2_dlc12_grn_leaf_cutterz_tribe	Confederation formed with the Leaf Cutterz tribe	false
campaign_payload_ui_details_description_dummy_confederate_wh2_dlc14_grn_red_cloud	Confederation formed with the Red Cloud tribe	false
campaign_payload_ui_details_description_dummy_confederate_wh2_dlc15_grn_bonerattlaz	Confederation formed with the Bonerattlaz tribe	false
campaign_payload_ui_details_description_dummy_confederate_wh2_dlc15_grn_broken_axe	Confederation formed with the Broken Axe tribe	false
campaign_payload_ui_details_description_dummy_confederate_wh2_dlc15_grn_skull_crag	Confederation formed with the Skull Crag tribe	false
campaign_payload_ui_details_description_dummy_confederate_wh2_main_dwf_spine_of_sotek_dwarfs	Confederation formed with Spine of Sotek Dwarfs	false
campaign_payload_ui_details_description_dummy_confederate_wh2_main_grn_arachnos	Confederation formed with the Arachnos tribe	false
campaign_payload_ui_details_description_dummy_confederate_wh2_main_grn_blue_vipers	Confederation formed with the Blue Vipers tribe	false
campaign_payload_ui_details_description_dummy_confederate_wh2_main_hef_caledor	Confederation formed with Caledor	false
campaign_payload_ui_details_description_dummy_confederate_wh2_main_nor_aghol	Confederation formed with the Aghol tribe	false
campaign_payload_ui_details_description_dummy_confederate_wh2_main_nor_mung	Confederation formed with the Mung tribe	false
campaign_payload_ui_details_description_dummy_confederate_wh2_main_nor_skeggi	Confederation formed with the Skeggi tribe	false
campaign_payload_ui_details_description_dummy_confederate_wh_dlc08_nor_goromadny_tribe	Confederation formed with the Goromadny Tribe	false
campaign_payload_ui_details_description_dummy_confederate_wh_dlc08_nor_helspire_tribe	Confederation formed with the Helspire Tribe	false
campaign_payload_ui_details_description_dummy_confederate_wh_dlc08_nor_naglfarlings	Confederation formed with the Naglfarlings tribe	false
campaign_payload_ui_details_description_dummy_confederate_wh_dlc08_nor_norsca	Confederation formed with Norsca	false
campaign_payload_ui_details_description_dummy_confederate_wh_dlc08_nor_vanaheimlings	Confederation formed with the Vanaheimlings tribe	false
campaign_payload_ui_details_description_dummy_confederate_wh_dlc08_nor_wintertooth	Confederation formed with Wintertooth	false
campaign_payload_ui_details_description_dummy_confederate_wissenland	Confederation formed with Wissenland	false
campaign_payload_ui_details_description_dummy_cst_dilemma_avoid_diplomatic_penalty	Avoid diplomatic penalties	false
campaign_payload_ui_details_description_dummy_diplomatic_attitude_change	Diplomatic relations: %+3% between %1% and %2%	false
campaign_payload_ui_details_description_dummy_dlc10_blood_voyage_next_turn	Blood Voyage will spawn next turn	false
campaign_payload_ui_details_description_dummy_dlc10_death_night_cost_increase	Death Night slave requirement: +100	false
campaign_payload_ui_details_description_dummy_do_nothing	Do nothing	false
campaign_payload_ui_details_description_dummy_elector_civil_war	[[col:yellow]]{{CcoCampaignPayloadInfoEntry:StoredContextFromParent("CcoCampaignEventDilemma").FirstTargetFactionNameWithIcon}} declares war on {{CcoCampaignPayloadInfoEntry:StoredContextFromParent("CcoCampaignEventDilemma").SecondTargetFactionNameWithIcon}}[[/col]]	false
campaign_payload_ui_details_description_dummy_elector_confederation	[[col:green]]Confederation formed with {{CcoCampaignPayloadInfoEntry:StoredContextFromParent("CcoCampaignEventDilemma").FirstTargetFactionNameWithIcon}}[[/col]]	false
campaign_payload_ui_details_description_dummy_elector_confederation_offer	[[col:yellow]]Confederation will be offered again in 20 turns[[/col]]	false
campaign_payload_ui_details_description_dummy_elector_invasion_beastmen	[[col:yellow]]You join the defence of {{CcoCampaignPayloadInfoEntry:StoredContextFromParent("CcoCampaignEventDilemma").RegionTargetName}} against {{CcoCampaignPayloadInfoEntry:StoredContextFromParent("CcoCampaignEventDilemma").SecondTargetFactionNameWithIcon}}[[/col]]	false
campaign_payload_ui_details_description_dummy_elector_invasion_beastmen_ai	[[col:yellow]]{{CcoCampaignPayloadInfoEntry:StoredContextFromParent("CcoCampaignEventDilemma").FirstTargetFactionName}} defend alone against {{CcoCampaignPayloadInfoEntry:StoredContextFromParent("CcoCampaignEventDilemma").SecondTargetFactionNameWithIcon}}[[/col]]	false
campaign_payload_ui_details_description_dummy_elector_invasion_greenskins	[[col:yellow]]You join the defence of {{CcoCampaignPayloadInfoEntry:StoredContextFromParent("CcoCampaignEventDilemma").RegionTargetName}} against {{CcoCampaignPayloadInfoEntry:StoredContextFromParent("CcoCampaignEventDilemma").SecondTargetFactionNameWithIcon}}[[/col]]	false
campaign_payload_ui_details_description_dummy_elector_invasion_greenskins_ai	[[col:yellow]]{{CcoCampaignPayloadInfoEntry:StoredContextFromParent("CcoCampaignEventDilemma").FirstTargetFactionName}} defend alone against {{CcoCampaignPayloadInfoEntry:StoredContextFromParent("CcoCampaignEventDilemma").SecondTargetFactionNameWithIcon}}[[/col]]	false
campaign_payload_ui_details_description_dummy_elector_invasion_norsca	[[col:yellow]]You join the defence of {{CcoCampaignPayloadInfoEntry:StoredContextFromParent("CcoCampaignEventDilemma").RegionTargetName}} against {{CcoCampaignPayloadInfoEntry:StoredContextFromParent("CcoCampaignEventDilemma").SecondTargetFactionNameWithIcon}}[[/col]]	false
campaign_payload_ui_details_description_dummy_elector_invasion_norsca_ai	[[col:yellow]]{{CcoCampaignPayloadInfoEntry:StoredContextFromParent("CcoCampaignEventDilemma").FirstTargetFactionName}} defend alone against {{CcoCampaignPayloadInfoEntry:StoredContextFromParent("CcoCampaignEventDilemma").SecondTargetFactionNameWithIcon}}[[/col]]	false
campaign_payload_ui_details_description_dummy_elector_invasion_skaven	[[col:yellow]]You join the defence of {{CcoCampaignPayloadInfoEntry:StoredContextFromParent("CcoCampaignEventDilemma").RegionTargetName}} against {{CcoCampaignPayloadInfoEntry:StoredContextFromParent("CcoCampaignEventDilemma").SecondTargetFactionNameWithIcon}}[[/col]]	false
campaign_payload_ui_details_description_dummy_elector_invasion_skaven_ai	[[col:yellow]]{{CcoCampaignPayloadInfoEntry:StoredContextFromParent("CcoCampaignEventDilemma").FirstTargetFactionName}} defend alone against {{CcoCampaignPayloadInfoEntry:StoredContextFromParent("CcoCampaignEventDilemma").SecondTargetFactionNameWithIcon}}[[/col]]	false
campaign_payload_ui_details_description_dummy_elector_loyalty_decrease_1	[[col:red]]Fealty of {{CcoCampaignPayloadInfoEntry:StoredContextFromParent("CcoCampaignEventDilemma").FirstTargetFactionNameWithIcon}}: -1 (Current: {{CcoCampaignPayloadInfoEntry:StoredContextFromParent("CcoCampaignEventDilemma").FirstTargetFactionPooledResource("emp_loyalty")}})[[/col]]	false
campaign_payload_ui_details_description_dummy_elector_loyalty_decrease_2	[[col:red]]Fealty of {{CcoCampaignPayloadInfoEntry:StoredContextFromParent("CcoCampaignEventDilemma").SecondTargetFactionNameWithIcon}}: -1 (Current: {{CcoCampaignPayloadInfoEntry:StoredContextFromParent("CcoCampaignEventDilemma").SecondTargetFactionPooledResource("emp_loyalty")}})[[/col]]	false
campaign_payload_ui_details_description_dummy_elector_loyalty_increase_1	[[col:green]]Fealty of {{CcoCampaignPayloadInfoEntry:StoredContextFromParent("CcoCampaignEventDilemma").FirstTargetFactionNameWithIcon}}: +1 (Current: {{CcoCampaignPayloadInfoEntry:StoredContextFromParent("CcoCampaignEventDilemma").FirstTargetFactionPooledResource("emp_loyalty")}})[[/col]]	false
campaign_payload_ui_details_description_dummy_elector_loyalty_increase_2	[[col:green]]Fealty of {{CcoCampaignPayloadInfoEntry:StoredContextFromParent("CcoCampaignEventDilemma").SecondTargetFactionNameWithIcon}}: +1 (Current: {{CcoCampaignPayloadInfoEntry:StoredContextFromParent("CcoCampaignEventDilemma").SecondTargetFactionPooledResource("emp_loyalty")}})[[/col]]	false
campaign_payload_ui_details_description_dummy_elector_loyalty_large_decrease_1	[[col:red]]Fealty of {{CcoCampaignPayloadInfoEntry:StoredContextFromParent("CcoCampaignEventDilemma").FirstTargetFactionNameWithIcon}}: -2 (Current: {{CcoCampaignPayloadInfoEntry:StoredContextFromParent("CcoCampaignEventDilemma").FirstTargetFactionPooledResource("emp_loyalty")}})[[/col]]	false
campaign_payload_ui_details_description_dummy_elector_loyalty_large_decrease_2	[[col:red]]Fealty of {{CcoCampaignPayloadInfoEntry:StoredContextFromParent("CcoCampaignEventDilemma").SecondTargetFactionNameWithIcon}}: -2 (Current: {{CcoCampaignPayloadInfoEntry:StoredContextFromParent("CcoCampaignEventDilemma").SecondTargetFactionPooledResource("emp_loyalty")}})[[/col]]	false
campaign_payload_ui_details_description_dummy_elector_loyalty_large_increase_1	[[col:green]]Fealty of {{CcoCampaignPayloadInfoEntry:StoredContextFromParent("CcoCampaignEventDilemma").FirstTargetFactionNameWithIcon}}: +2 (Current: {{CcoCampaignPayloadInfoEntry:StoredContextFromParent("CcoCampaignEventDilemma").FirstTargetFactionPooledResource("emp_loyalty")}})[[/col]]	false
campaign_payload_ui_details_description_dummy_elector_loyalty_large_increase_2	[[col:green]]Fealty of {{CcoCampaignPayloadInfoEntry:StoredContextFromParent("CcoCampaignEventDilemma").SecondTargetFactionNameWithIcon}}: +2 (Current: {{CcoCampaignPayloadInfoEntry:StoredContextFromParent("CcoCampaignEventDilemma").SecondTargetFactionPooledResource("emp_loyalty")}})[[/col]]	false
campaign_payload_ui_details_description_dummy_elector_player_civil_war	[[col:red]]All Elector Counts declare war on you![[/col]]	false
campaign_payload_ui_details_description_dummy_elector_region_return	{{CcoCampaignPayloadInfoEntry:StoredContextFromParent("CcoCampaignEventDilemma").RegionTargetName}} will be returned to {{CcoCampaignPayloadInfoEntry:StoredContextFromParent("CcoCampaignEventDilemma").FirstTargetFactionNameWithIcon}}	false
campaign_payload_ui_details_description_dummy_elector_region_taken	{{CcoCampaignPayloadInfoEntry:StoredContextFromParent("CcoCampaignEventDilemma").SecondTargetFactionNameWithIcon}} will retain control of {{CcoCampaignPayloadInfoEntry:StoredContextFromParent("CcoCampaignEventDilemma").RegionTargetName}}	false
campaign_payload_ui_details_description_dummy_elector_scout_region	[[col:yellow]]You gain visibility over the region of {{CcoCampaignPayloadInfoEntry:StoredContextFromParent("CcoCampaignEventDilemma").RegionTargetName}}[[/col]]	false
campaign_payload_ui_details_description_dummy_elector_stop_civil_war	[[col:green]]Civil War between the two Electors has been prevented[[/col]]	false
campaign_payload_ui_details_description_dummy_elector_stop_succession	[[col:green]]The Secession of {{CcoCampaignPayloadInfoEntry:StoredContextFromParent("CcoCampaignEventDilemma").FirstTargetFactionNameWithIcon}} has been prevented[[/col]]	false
campaign_payload_ui_details_description_dummy_elector_war_declared_1	[[col:red]]War Declared on {{CcoCampaignPayloadInfoEntry:StoredContextFromParent("CcoCampaignEventDilemma").FirstTargetFactionNameWithIcon}}[[/col]]	false
campaign_payload_ui_details_description_dummy_elector_war_declared_2	[[col:red]]War Declared on {{CcoCampaignPayloadInfoEntry:StoredContextFromParent("CcoCampaignEventDilemma").SecondTargetFactionNameWithIcon}}[[/col]]	false
campaign_payload_ui_details_description_dummy_endgame_vermintide_ubersreik	An elite army containing a mix of Empire, Dwarf, and Wood Elf heroes will join you.	false
campaign_payload_ui_details_description_dummy_enemy_leader_killed	Enemy faction leader is killed... [[col:red]]permanently[[/col]]	false
campaign_payload_ui_details_description_dummy_exalted_hero_capacity	Hero capacity: +1 for Exalted Heroes	false
campaign_payload_ui_details_description_dummy_flesh_lab_batch_available_1	Releasing Growth Vat batches more frequently maximises Mutagen production	false
campaign_payload_ui_details_description_dummy_flesh_lab_batch_available_2	Waiting for better monsters results in less efficient Mutagen production	false
campaign_payload_ui_details_description_dummy_lzd_oxyotl_the_golden_blowpipe_of_ptoohee_fight_battle	Quest Battle is fought now but enemy force will have reinforcements	false
campaign_payload_ui_details_description_dummy_lzd_oxyotl_the_golden_blowpipe_of_ptoohee_next_stage	Quest Battle is fought later and enemy will fight without reinforcements	false
campaign_payload_ui_details_description_dummy_marker_will_persist	You will be able to return to this marker later	false
campaign_payload_ui_details_description_dummy_monster_pen_modifiers	High enemy casualties and Rakarth's rank increases the chance of capturing Monsters	false
campaign_payload_ui_details_description_dummy_monster_pens	Captured units can be instantly recruited from the Monster Pens	false
campaign_payload_ui_details_description_dummy_mortal_worlds_torment_decrease	[[col:green]]Mortal World's Torment trait changed[[/col]]	false
campaign_payload_ui_details_description_dummy_mortal_worlds_torment_increase	[[col:dark_r]]Mortal World's Torment trait changed[[/col]]	false
campaign_payload_ui_details_description_dummy_ocean_of_opportunities_first	This option generates a mission with a Medium Reward	false
campaign_payload_ui_details_description_dummy_ocean_of_opportunities_fourth	This option generates a mission with a Low Reward	false
campaign_payload_ui_details_description_dummy_ocean_of_opportunities_second	This option generates a mission with a High Reward	false
campaign_payload_ui_details_description_dummy_ocean_of_opportunities_third	This option generates a mission with a High Reward	false
campaign_payload_ui_details_description_dummy_province_development_point	Vassal gains a province population surplus	false
campaign_payload_ui_details_description_dummy_rakarth_battles_harpies	Earned by slaughtering captives after winning a land or sea battle	false
campaign_payload_ui_details_description_dummy_rakarth_battles_sea	Earned by slaughtering captives after a battle at sea	false
campaign_payload_ui_details_description_dummy_rakarth_battles_underway	Earned by slaughtering captives after winning a battle in the Underway	false
campaign_payload_ui_details_description_dummy_rakarth_raid_cold_ones	Earned by raiding in a Jungle or Savannah climate	false
campaign_payload_ui_details_description_dummy_rakarth_raid_desert	Earned by raiding in a Desert climate	false
campaign_payload_ui_details_description_dummy_rakarth_raid_frozen	Earned by raiding in a Frozen climate	false
campaign_payload_ui_details_description_dummy_rakarth_raid_jungle	Earned by raiding in a Jungle climate	false
campaign_payload_ui_details_description_dummy_rakarth_raid_magical_forest	Earned by raiding in a Magical Forest climate	false
campaign_payload_ui_details_description_dummy_rakarth_raid_manticore	Earned by raiding in a Chaotic Wasteland or Chaos-corrupted region	false
campaign_payload_ui_details_description_dummy_rakarth_raid_mountain	Earned by raiding in a Mountain climate	false
campaign_payload_ui_details_description_dummy_rakarth_raid_temperate	Earned by raiding in a Temperate climate	false
campaign_payload_ui_details_description_dummy_rakarth_raid_temperate_island	Earned by raiding in a Temperate Island climate	false
campaign_payload_ui_details_description_dummy_rakarth_raid_wasteland	Earned by raiding in a Wasteland climate	false
campaign_payload_ui_details_description_dummy_rakarth_settlement_chaos	Earned by capturing a Warriors of Chaos settlement	false
campaign_payload_ui_details_description_dummy_rakarth_settlement_dark_elves	Earned by capturing a Dark Elf settlement	false
campaign_payload_ui_details_description_dummy_rakarth_settlement_dragon	Earned by capturing a High Elf or Dark Elf settlement	false
campaign_payload_ui_details_description_dummy_rakarth_settlement_greenskins	Earned by capturing a Greenskin settlement	false
campaign_payload_ui_details_description_dummy_rakarth_settlement_kislev	Earned by capturing a Kislev settlement	false
campaign_payload_ui_details_description_dummy_rakarth_settlement_lizardmen	Earned by capturing a Lizardmen settlement	false
campaign_payload_ui_details_description_dummy_rakarth_settlement_norsca	Earned by capturing a Norscan settlement	false
campaign_payload_ui_details_description_dummy_rakarth_settlement_ogres	Earned by capturing an Ogres settlement	false
campaign_payload_ui_details_description_dummy_rakarth_settlement_wood_elves	Earned by capturing a Wood Elf settlement	false
campaign_payload_ui_details_description_dummy_region_returned_to_high_elves	Gaean Vale will be returned to a High Elf faction	false
campaign_payload_ui_details_description_dummy_sisters_forge_active_1	The Forge of Daith button is now active!	false
campaign_payload_ui_details_description_dummy_sisters_forge_active_2	The Forge of Daith can only be accessed once every 2 turns	false
campaign_payload_ui_details_description_dummy_sisters_forge_event_1	Lord Daith has gifted you four pieces of equipment	false
campaign_payload_ui_details_description_dummy_sisters_forge_event_2	Lord Daith gifts new equipment every 10 turns	false
campaign_payload_ui_details_description_dummy_sisters_forge_event_3	Lord Daith will offer to improve his gifts after the Sisters win battles	false
campaign_payload_ui_details_description_dummy_sorcerer_capacity	Hero capacity: +1 for Chaos Sorcerers	false
campaign_payload_ui_details_description_dummy_spawn_lord_kroak	Unlock Hero: Lord Kroak	false
campaign_payload_ui_details_description_dummy_sword_will_be_lost	Return the Sword of Khaine	false
campaign_payload_ui_details_description_dummy_sword_will_be_picked	Keep the Sword of Khaine	false
campaign_payload_ui_details_description_dummy_sword_will_be_strong	The Sword of Khaine will grow in power	false
campaign_payload_ui_details_description_dummy_take_no_action	You will take no action	false
campaign_payload_ui_details_description_dummy_vortex_final_battle_experience	Bonus experience: 8000 for all characters	false
campaign_payload_ui_details_description_dummy_vortex_final_battle_unit_rank	Unit rank: 9 for all units in the battle	false
campaign_payload_ui_details_description_dummy_wef_encounter_confed_oreon	Confederation formed with the Bowmen of Oreon	false
campaign_payload_ui_details_description_dummy_wef_encounter_easy_battle	You will face a [[col:green]]weaker[[/col]] foe in battle	false
campaign_payload_ui_details_description_dummy_wef_encounter_greenskins	Dark Elf regions will suffer intermittent penalties	false
campaign_payload_ui_details_description_dummy_wef_encounter_hard_battle	You will face a [[col:red]]stronger[[/col]] foe in battle	false
campaign_payload_ui_details_description_dummy_wef_encounter_very_hard_battle	You will face a [[col:red]]very difficult[[/col]] foe in battle	false
campaign_payload_ui_details_description_dummy_wef_encounter_war_with_oreon	You will go to war with the Bowmen of Oreon!	false
campaign_payload_ui_details_description_dummy_wh2_dlc11_neo_counter_fight	You will face a foe in battle	false
campaign_payload_ui_details_description_dummy_wh2_dlc11_neo_counter_fight_chance	You may have to defeat a foe in battle	false
campaign_payload_ui_details_description_dummy_wh2_dlc11_neo_counter_treasure	A great hoard of treasure may be received	false
campaign_payload_ui_details_description_dummy_wh2_dlc11_neo_counter_treasure_minor	Only a miserly hoard of treasure will be received	false
campaign_payload_ui_details_description_dummy_wh2_dlc13_hunter_dilemma	[[col:white]]A dilemma offers rewards![[/col]]	false
campaign_payload_ui_details_description_dummy_wh2_dlc13_hunter_join	[[col:white]]A unique Hero joins your cause![[/col]]	false
campaign_payload_ui_details_description_dummy_wh2_dlc13_wulfhart_supply_delay	HIDDEN delay your next imperial supply	false
campaign_payload_ui_details_description_dummy_wh2_dlc13_wulfhart_supply_enhance	HIDDEN recieve extra units in next imperial supply	false
campaign_payload_ui_details_description_dummy_wh2_dlc13_wulfhart_supply_instant	HIDDEN receive ur next imperial supply instantly	false
campaign_payload_ui_details_description_dummy_wh2_dlc13_wulfhart_wanted_level_increase	HIDDEN wanted level will increase by 1	false
campaign_payload_ui_details_description_dummy_wh2_dlc14_malus_start_dilemma_keep_hag_graef	Keep Hag Graef (Retain a foothold in Naggaroth)	false
campaign_payload_ui_details_description_dummy_wh2_dlc14_malus_start_dilemma_lose_hag_graef	Give up Hag Graef (Focus on the expedition)	false
campaign_payload_ui_details_description_dummy_wh2_dlc14_obsinite_gyrocopter_unlock	Imperial Troops (1) Obsinite Gyrocopter	false
campaign_payload_ui_details_description_dummy_wh2_dlc15_dragon_encounter_bargain	The Dragon will show you the art of manipulation!	false
campaign_payload_ui_details_description_dummy_wh2_dlc15_dragon_encounter_challenge	You will fight this Dragon in battle!	false
campaign_payload_ui_details_description_dummy_wh2_dlc15_dragon_encounter_challenge_special	Fight this Dragon in its Lair! This option enables a \\n quest battle with greater rewards	false
campaign_payload_ui_details_description_dummy_wh2_dlc15_dragon_encounter_consult	The Dragon's knowledge improves your armies	false
campaign_payload_ui_details_description_dummy_wh2_dlc15_dragon_encounter_leave	You will leave this Dragon alone for now	false
campaign_payload_ui_details_description_dummy_wh2_dlc15_grom_experience	Bonus experience: 1500 for Grom	false
campaign_payload_ui_details_description_dummy_wh2_dlc15_grom_random_food	A random ingredient will be unlocked	false
campaign_payload_ui_details_description_dummy_wh2_dlc15_imrik_dragon_recruitment_black	Special Dragon (1) Shackolot the Calamity	false
campaign_payload_ui_details_description_dummy_wh2_dlc15_imrik_dragon_recruitment_forest	Special Dragon (1) Bruwor, Protector of Life	false
campaign_payload_ui_details_description_dummy_wh2_dlc15_imrik_dragon_recruitment_moon	Special Dragon (1) Lamoureux the Frozen Breath	false
campaign_payload_ui_details_description_dummy_wh2_dlc15_imrik_dragon_recruitment_star	Special Dragon (1) Ymwrath the Eternal	false
campaign_payload_ui_details_description_dummy_wh2_dlc15_imrik_dragon_recruitment_sun	Special Dragon (1) Gordinar, Champion of the Flame	false
campaign_payload_ui_details_description_dummy_wh2_dlc16_drycha_potion_sacre_reward	Drycha and her followers will gain magical resistance	false
campaign_payload_ui_details_description_dummy_wh2_dlc16_drycha_unlock_coeddil_reward	Coeddil will join your forces	false
campaign_payload_ui_details_description_dummy_wh2_dlc16_sisters_forge_craft_armour	You will receive a powerful set of armour	false
campaign_payload_ui_details_description_dummy_wh2_dlc16_sisters_forge_craft_enchanted_item	You will receive a powerful enchanted item	false
campaign_payload_ui_details_description_dummy_wh2_dlc16_sisters_forge_craft_no_more_available	Daith can no longer craft equipment of this type to gift you	false
campaign_payload_ui_details_description_dummy_wh2_dlc16_sisters_forge_craft_talisman	You will receive a powerful talisman	false
campaign_payload_ui_details_description_dummy_wh2_dlc16_sisters_forge_craft_weapon	You will receive a powerful weapon	false
campaign_payload_ui_details_description_dummy_wh2_dlc16_sisters_forge_leave_without_action	Naestra pays her respects and leaves	false
campaign_payload_ui_details_description_dummy_wh2_dlc16_sisters_forge_leave_without_action_2	Daith is pleased: -2 turns until next Forge of Daith gift	false
campaign_payload_ui_details_description_dummy_wh2_dlc16_sisters_forge_lose_reforge_warning	Equipment currently reforged – remaining power duration is lost	false
campaign_payload_ui_details_description_dummy_wh2_dlc16_sisters_forge_reforge_duration_warning	Equipment's increased power lasts 5 turns	false
campaign_payload_ui_details_description_dummy_wh2_dlc16_sisters_forge_reforge_duration_warning_skill_owned	Equipment's increased power lasts 7 turns	false
campaign_payload_ui_details_description_dummy_wh2_dlc16_sisters_forge_reforge_level_warning	Will revert back to its current power after reforge duration	false
campaign_payload_ui_details_description_dummy_wh2_dlc16_sisters_forge_restart_reforge_timer	Equipment currently reforged – power duration reset to maximum	false
campaign_payload_ui_details_description_dummy_wh2_dlc16_throt_unlock_ghoritch_reward	Ghoritch will join your forces	false
campaign_payload_ui_details_description_dummy_wh2_main_campaign_encounter	Your army will perform better on campaign	false
campaign_payload_ui_details_description_dummy_wh2_main_combat_encounter	Your army will perform better in battle	false
campaign_payload_ui_details_description_dummy_wh2_main_grn_gorks_waaagh	You dedicate this Waaagh! to Gork	false
campaign_payload_ui_details_description_dummy_wh2_main_grn_morks_waaagh	You dedicate this Waaagh! to Mork	false
campaign_payload_ui_details_description_dummy_wh2_main_incident_intercontinental_diplomacy	All major port owners have become known to each other via diplomacy	false
campaign_payload_ui_details_description_dummy_wh2_pro08_recruit	Recruit Gotrek and Felix	false
campaign_payload_ui_details_description_dummy_wh2_twa03_rakarth_beast_mastery_reward	Some Lustrian beasts will be added to the Monster Pens	false
campaign_payload_ui_details_description_dummy_wh2_twa03_rakarth_black_ark_reward	A Black Ark will become available for recruitment from any port settlement	false
campaign_payload_ui_details_description_dummy_wh3_dlc20_dilemma_daemon_prince_ascension_ascend	Character replaced with a Daemon Prince	false
campaign_payload_ui_details_description_dummy_wh3_dlc20_dilemma_daemon_prince_ascension_do_nothing	Continue as a Mortal permanently	false
campaign_payload_ui_details_description_dummy_wh3_dlc20_incident_daemon_prince_ascension	Some experience has been transferred to the Daemon Prince	false
campaign_payload_ui_details_description_dummy_wh3_dlc21_dilemma_nakai_pestilens_short_victory	A wandering army under your control will emerge from the jungles of Lustria to aid the Lizardmen.	false
campaign_payload_ui_details_description_dummy_wh3_main_ai_four_souls_forge_of_souls	All souls collected by the enemy are lost!	false
campaign_payload_ui_details_description_dummy_wh3_main_bundle_belakor_banished	Be'lakor will join your faction	false
campaign_payload_ui_details_description_dummy_wh3_main_dilemma_boris_unlock_first	Kislev settlement gifted to Ursun Revivalists	false
campaign_payload_ui_details_description_dummy_wh3_main_dilemma_boris_unlock_fourth	Boris Ursus is available for recruitment	false
campaign_payload_ui_details_description_dummy_wh3_main_dilemma_boris_unlock_second	Erengrad settlement gifted to Ursun Revivalists	false
campaign_payload_ui_details_description_dummy_wh3_main_dilemma_boris_unlock_third	Praag settlement gifted to Ursun Revivalists	false
campaign_payload_ui_details_description_dummy_wh3_main_dilemma_exalted_greater_daemon_ask_again	You will be asked again in 10 turns	false
campaign_payload_ui_details_description_dummy_wh3_main_dilemma_exalted_greater_daemon_do_nothing	Continue as a Herald permanently	false
campaign_payload_ui_details_description_dummy_wh3_main_dilemma_exalted_greater_daemon_khorne	Character replaced with an Exalted Bloodthirster	false
campaign_payload_ui_details_description_dummy_wh3_main_dilemma_exalted_greater_daemon_nurgle	Character replaced with an Exalted Great Unclean One	false
campaign_payload_ui_details_description_dummy_wh3_main_dilemma_exalted_greater_daemon_slaanesh	Character replaced with an Exalted Keeper of Secrets	false
campaign_payload_ui_details_description_dummy_wh3_main_dilemma_exalted_greater_daemon_tzeentch	Character replaced with an Exalted Lord of Change	false
campaign_payload_ui_details_description_dummy_wh3_main_dilemma_forge_of_souls_entered	Your faction leader will be immediately teleported to the Forge of Souls rift	false
campaign_payload_ui_details_description_dummy_wh3_main_eltharion_start_dilemma_keep_yvresse	Keep Yvresse (Retain your control in Ulthuan)	false
campaign_payload_ui_details_description_dummy_wh3_main_eltharion_start_dilemma_lose_yvresse	Give up Yvresse (Focus on the Badlands)	false
campaign_payload_ui_details_description_dummy_wh3_main_incident_cth_bastion_threat_decreases_kill	Great Bastion threat: -20%	false
campaign_payload_ui_details_description_dummy_wh3_main_incident_dae_feature_khorne	Unlocks the "Bloodletting" feature for all your armies	false
campaign_payload_ui_details_description_dummy_wh3_main_incident_dae_feature_nurgle	Unlocks the "Switchable Plagues" feature for all your armies	false
campaign_payload_ui_details_description_dummy_wh3_main_incident_dae_feature_slaanesh	Unlocks the "Seduce Units" feature for all your armies	false
campaign_payload_ui_details_description_dummy_wh3_main_incident_dae_feature_tzeentch	Unlocks the Teleport stance for all your armies	false
campaign_payload_ui_details_description_dummy_wh3_main_incident_exalted_greater_daemon	Some experience has been transferred to the Exalted Greater Daemon	false
campaign_payload_ui_details_description_dummy_wh3_main_incident_ogr_contracts_available	New contracts are available for selection	false
campaign_payload_ui_details_description_dummy_wh3_main_khorne_realm_requirement	A chance to fight at the Brass Citadel	false
campaign_payload_ui_details_description_dummy_wh3_main_leave_slaanesh_realm	Your army will leave the Realm of Chaos, unable to return for the foreseeable future	false
campaign_payload_ui_details_description_dummy_wh3_main_nurgle_realm_requirement	A chance to fight at the Mansion of the Plaguelord	false
campaign_payload_ui_details_description_dummy_wh3_main_qb_ksl_katarin_boris_unlock	Boris Ursus will return	false
campaign_payload_ui_details_description_dummy_wh3_main_realm_slaanesh_fifth_10	All [[img:icon_general]][[/img]]Lords and [[img:icon_hero]][[/img]]Heroes increase rank by 10	false
campaign_payload_ui_details_description_dummy_wh3_main_realm_slaanesh_fifth_15	All [[img:icon_general]][[/img]]Lords and [[img:icon_hero]][[/img]]Heroes increase rank by 15	false
campaign_payload_ui_details_description_dummy_wh3_main_realm_slaanesh_fifth_5	All [[img:icon_general]][[/img]]Lords and [[img:icon_hero]][[/img]]Heroes increase rank by 5	false
campaign_payload_ui_details_description_dummy_wh3_main_realm_slaanesh_fourth_4	Unit rank: 4 for all units in this army	false
campaign_payload_ui_details_description_dummy_wh3_main_realm_slaanesh_fourth_9	Unit rank: 9 for all units in this army	false
campaign_payload_ui_details_description_dummy_wh3_main_story_panel_ascension	[[col:red]]You will lose the campaign if you do not defeat him at the Forge of Souls![[/col]]	false
campaign_payload_ui_details_description_dummy_wh3_main_story_panel_ascension_close	[[col:red]]Be'lakor will become a God in 20 turns[[/col]]	false
campaign_payload_ui_details_description_dummy_wh3_main_story_panel_ascension_coming	[[col:red]]Be'lakor will become a God in 30 turns[[/col]]	false
campaign_payload_ui_details_description_dummy_wh3_main_story_panel_ascension_imminent	[[col:red]]Be'lakor will become a God in 10 turns[[/col]]	false
campaign_payload_ui_details_description_dummy_wh3_main_survival_forge_of_souls	Campaign Victory!	false
campaign_payload_ui_details_description_dummy_wh3_main_survival_khorne_1	A Daemon Prince's soul\\n(1 of 4 needed to discover the path to the Forge of Souls)	false
campaign_payload_ui_details_description_dummy_wh3_main_survival_khorne_2	A Daemon Prince's soul\\n(2 of 4 needed to discover the path to the Forge of Souls)	false
campaign_payload_ui_details_description_dummy_wh3_main_survival_khorne_3	A Daemon Prince's soul\\n(3 of 4 needed to discover the path to the Forge of Souls)	false
campaign_payload_ui_details_description_dummy_wh3_main_survival_khorne_4	A Daemon Prince's soul\\n(4 of 4 needed to discover the path to the Forge of Souls)	false
campaign_payload_ui_details_description_dummy_wh3_main_survival_nurgle_1	A Daemon Prince's soul\\n(1 of 4 needed to discover the path to the Forge of Souls)	false
campaign_payload_ui_details_description_dummy_wh3_main_survival_nurgle_2	A Daemon Prince's soul\\n(2 of 4 needed to discover the path to the Forge of Souls)	false
campaign_payload_ui_details_description_dummy_wh3_main_survival_nurgle_3	A Daemon Prince's soul\\n(3 of 4 needed to discover the path to the Forge of Souls)	false
campaign_payload_ui_details_description_dummy_wh3_main_survival_nurgle_4	A Daemon Prince's soul\\n(4 of 4 needed to discover the path to the Forge of Souls)	false
campaign_payload_ui_details_description_dummy_wh3_main_survival_slaanesh_1	A Daemon Prince's soul\\n(1 of 4 needed to discover the path to the Forge of Souls)	false
campaign_payload_ui_details_description_dummy_wh3_main_survival_slaanesh_2	A Daemon Prince's soul\\n(2 of 4 needed to discover the path to the Forge of Souls)	false
campaign_payload_ui_details_description_dummy_wh3_main_survival_slaanesh_3	A Daemon Prince's soul\\n(3 of 4 needed to discover the path to the Forge of Souls)	false
campaign_payload_ui_details_description_dummy_wh3_main_survival_slaanesh_4	A Daemon Prince's soul\\n(4 of 4 needed to discover the path to the Forge of Souls)	false
campaign_payload_ui_details_description_dummy_wh3_main_survival_tzeentch_1	A Daemon Prince's soul\\n(1 of 4 needed to discover the path to the Forge of Souls)	false
campaign_payload_ui_details_description_dummy_wh3_main_survival_tzeentch_2	A Daemon Prince's soul\\n(2 of 4 needed to discover the path to the Forge of Souls)	false
campaign_payload_ui_details_description_dummy_wh3_main_survival_tzeentch_3	A Daemon Prince's soul\\n(3 of 4 needed to discover the path to the Forge of Souls)	false
campaign_payload_ui_details_description_dummy_wh3_main_survival_tzeentch_4	A Daemon Prince's soul\\n(4 of 4 needed to discover the path to the Forge of Souls)	false
campaign_payload_ui_details_description_dummy_wh3_main_tzeentch_realm_powerful_reward	A boon from the Chaos God of Magic is yours to take	false
campaign_payload_ui_details_description_dummy_wh3_main_tzeentch_realm_replenishment_dilemma_payload	Fully replenishes army	false
campaign_payload_ui_details_description_dummy_wh3_main_tzeentch_realm_reveal_icon_pair	Reveal sigils for teleport pairing	false
campaign_payload_ui_details_description_dummy_wh3_main_units_replenished	All damaged units will be fully replenished	false
campaign_payload_ui_details_description_dummy_wh3_mission_fail	[[col:red]]You will lose the campaign if you do not complete this mission in time.[[/col]]	false
campaign_payload_ui_details_description_dummy_wh3_prologue_changer_of_the_ways_1	Unlock Snow Leopard	false
campaign_payload_ui_details_description_dummy_wh3_prologue_changer_of_the_ways_2	Unlock Bear War Sleds	false
campaign_payload_ui_details_description_dummy_wh3_prologue_ice_maiden_actions	Unlock Ice Guard (Swords)	false
campaign_payload_ui_details_description_dummy_wh3_prologue_mission	[[img:icon_campaign_objectives]][[/img]]	false
campaign_payload_ui_details_description_dummy_wh3_prologue_mission_building_level	Unlock Gryphon Legion	false
campaign_payload_ui_details_description_dummy_wh3_prologue_mission_capture_regions_mansion_of_eyes	Unlock Ice Guard (Glaives)	false
campaign_payload_ui_details_description_dummy_wh3_prologue_mission_make_alliance	Unlock Heavy Bear War Sleds	false
campaign_payload_ui_details_description_dummy_wh3_prologue_mission_retribution	Complete the Prologue	false
campaign_payload_ui_details_description_dummy_wh3_prologue_mission_reveal	Unlock Elemental Bear	false
campaign_payload_ui_details_description_dummy_wh3_prologue_mission_riddles	Unlock Patriarch	false
campaign_payload_ui_details_description_dummy_wh3_prologue_trait	Yuri will gain or reinforce a trait	false
campaign_payload_ui_details_description_dummy_wh3_prologue_trait_2	Yuri will gain or reinforce a different trait	false
campaign_payload_ui_details_description_dummy_wh3_prologue_tribute_1	Gain powerful item	false
campaign_payload_ui_details_description_dummy_wh3_prologue_tribute_2	Gain average item and diplomatic bonus with tribes	false
campaign_payload_ui_details_description_dummy_wh_dlc03_moon_chance	[[col:green]]Good chance of favourable outcome[[/col]]	false
campaign_payload_ui_details_description_dummy_wh_dlc03_moon_chance_none	[[col:red]]Less favourable outcome[[/col]]	false
campaign_payload_ui_details_description_dummy_wh_dlc04_vmp_vlad_von_carstein_the_carstein_ring_stage_2_3	Host a masquerade. {{tr:treasury}}: -5000	false
campaign_payload_ui_details_description_dummy_wh_main_dwf_thorgrim_grudgebearer_axe_of_grimnir_stage_1	Invest in the Guild's workshops. {{tr:treasury}}: -5000	false
campaign_payload_ui_details_description_dummy_wh_main_dwf_thorgrim_grudgebearer_dragon_crown_of_karaz_stage_2.3	Supply the fugitives. {{tr:treasury}}: -2500	false
campaign_payload_ui_details_description_dummy_wh_main_emp_karl_franz_ghal_maraz_stage_2	Fund the astrolabe adjustments. {{tr:treasury}}: -5000	false
campaign_payload_ui_details_description_dummy_wh_main_vmp_mannfred_von_carstein_sword_of_unholy_power_stage_2	Pay the Necromancer for the book. {{tr:treasury}}: -5000	false
campaign_payload_ui_details_description_dummy_witchwood_heal	Securing this location will help to heal the Witchwood	false
campaign_payload_ui_details_description_faction_pooled_resource_transaction	%1%: %+2%	false
campaign_payload_ui_details_description_faction_slaves_change	{{tr:slaves}}: %+1%	false
campaign_payload_ui_details_description_favour_points_change	Allegiance: %+1% with %2%	false
campaign_payload_ui_details_description_gain_ancillary		false
campaign_payload_ui_details_description_gain_trait	%1% gains trait: %2%	false
campaign_payload_ui_details_description_give_region		false
campaign_payload_ui_details_description_gravitas_change		false
campaign_payload_ui_details_description_honour_change_negative		false
campaign_payload_ui_details_description_honour_change_positive		false
campaign_payload_ui_details_description_influence_change	Influence: %+1%	false
campaign_payload_ui_details_description_issue_mission		false
campaign_payload_ui_details_description_kill_character		false
campaign_payload_ui_details_description_lose_ancillary		false
campaign_payload_ui_details_description_lose_trait	%1% loses trait: %2%	false
campaign_payload_ui_details_description_loyalty_change	Loyalty: %+1%	false
campaign_payload_ui_details_description_marriage_random		false
campaign_payload_ui_details_description_military_force_pooled_resource_transaction	%2%: %+3% for %1%	false
campaign_payload_ui_details_description_party_power_change		false
campaign_payload_ui_details_description_province_slaves_change	{{tr:slaves}} in %2%: %+1%	false
campaign_payload_ui_details_description_rebellion	Rebellion	false
campaign_payload_ui_details_description_remove_unit	Destroy unit: %1%	false
campaign_payload_ui_details_description_spawn_agent	Hero recruited: %1%	false
campaign_payload_ui_details_description_spawn_agent_home_region	Hero recruited at %2%: %1%	false
campaign_payload_ui_details_description_spawn_agent_home_region_unknown		false
campaign_payload_ui_details_description_spawn_unit	%1%	false
campaign_payload_ui_details_description_spawn_unit_home_region	%1%	false
campaign_payload_ui_details_description_treasury_change	{{tr:treasury}}: %+1%	false
campaign_payload_ui_details_description_wound_character	Character wounded: %1%	false
