key	text	tooltip
#Loc;1;text/db/character_skill_node_sets__.loc		
character_skill_node_sets_enc_title_wh2_dlc09_skill_node_set_skv_tretch_craventail	Tretch Craventail Skills	false
character_skill_node_sets_enc_title_wh2_dlc09_skill_node_set_tmb_arkhan	Arkhan Skills	false
character_skill_node_sets_enc_title_wh2_dlc09_skill_node_set_tmb_khalida	Khalida Skills	false
character_skill_node_sets_enc_title_wh2_dlc09_skill_node_set_tmb_khatep	Khatep Skills	false
character_skill_node_sets_enc_title_wh2_dlc09_skill_node_set_tmb_liche_priest_death	Liche Priest Skills	false
character_skill_node_sets_enc_title_wh2_dlc09_skill_node_set_tmb_liche_priest_light	Liche Priest Skills	false
character_skill_node_sets_enc_title_wh2_dlc09_skill_node_set_tmb_liche_priest_nehekhara	Liche Priest Skills	false
character_skill_node_sets_enc_title_wh2_dlc09_skill_node_set_tmb_liche_priest_shadow	Liche Priest Skills	false
character_skill_node_sets_enc_title_wh2_dlc09_skill_node_set_tmb_necrotect	Necrotect Skills	false
character_skill_node_sets_enc_title_wh2_dlc09_skill_node_set_tmb_necrotect_ritual	Necrotect Skills	false
character_skill_node_sets_enc_title_wh2_dlc09_skill_node_set_tmb_settra	Settra Skills	false
character_skill_node_sets_enc_title_wh2_dlc09_skill_node_set_tmb_tomb_king	Tomb King Skills	false
character_skill_node_sets_enc_title_wh2_dlc09_skill_node_set_tmb_tomb_king_alkhazzar_ii	Tomb King Skills	false
character_skill_node_sets_enc_title_wh2_dlc09_skill_node_set_tmb_tomb_king_lahmizzash	Tomb King Skills	false
character_skill_node_sets_enc_title_wh2_dlc09_skill_node_set_tmb_tomb_king_rakhash	Tomb King Skills	false
character_skill_node_sets_enc_title_wh2_dlc09_skill_node_set_tmb_tomb_king_setep	Tomb King Skills	false
character_skill_node_sets_enc_title_wh2_dlc09_skill_node_set_tmb_tomb_king_thutep	Tomb King Skills	false
character_skill_node_sets_enc_title_wh2_dlc09_skill_node_set_tmb_tomb_king_wakhaf	Tomb King Skills	false
character_skill_node_sets_enc_title_wh2_dlc09_skill_node_set_tmb_tomb_prince	Tomb Prince Skills	false
character_skill_node_sets_enc_title_wh2_dlc10_skill_node_set_def_crone	Crone Hellebron Skills	false
character_skill_node_sets_enc_title_wh2_dlc10_skill_node_set_def_sorceress_beasts	Sorceress (Beasts) Skills	false
character_skill_node_sets_enc_title_wh2_dlc10_skill_node_set_def_sorceress_death	Sorceress (Death) Skills	false
character_skill_node_sets_enc_title_wh2_dlc10_skill_node_set_def_supreme_sorceress_beasts	Supreme Sorceress (Beasts) Skills	false
character_skill_node_sets_enc_title_wh2_dlc10_skill_node_set_def_supreme_sorceress_dark	Supreme Sorceress (Dark) Skills	false
character_skill_node_sets_enc_title_wh2_dlc10_skill_node_set_def_supreme_sorceress_death	Supreme Sorceress (Death) Skills	false
character_skill_node_sets_enc_title_wh2_dlc10_skill_node_set_def_supreme_sorceress_fire	Supreme Sorceress (Fire) Skills	false
character_skill_node_sets_enc_title_wh2_dlc10_skill_node_set_def_supreme_sorceress_shadow	Supreme Sorceress (Shadows) Skills	false
character_skill_node_sets_enc_title_wh2_dlc10_skill_node_set_hef_alarielle	Alarielle Skills	false
character_skill_node_sets_enc_title_wh2_dlc10_skill_node_set_hef_alith_anar	Alith Anar Skills	false
character_skill_node_sets_enc_title_wh2_dlc10_skill_node_set_hef_handmaiden	Handmaiden Skills	false
character_skill_node_sets_enc_title_wh2_dlc10_skill_node_set_hef_mage_heavens	Mage (Heavens) Skills	false
character_skill_node_sets_enc_title_wh2_dlc10_skill_node_set_hef_mage_shadows	Mage (Shadows) Skills	false
character_skill_node_sets_enc_title_wh2_dlc11_skill_node_set_cst_admiral	Vampire Fleet Admiral Skills	false
character_skill_node_sets_enc_title_wh2_dlc11_skill_node_set_cst_admiral_death	Vampire Fleet Admiral Skills	false
character_skill_node_sets_enc_title_wh2_dlc11_skill_node_set_cst_admiral_deep	Vampire Fleet Admiral Skills	false
character_skill_node_sets_enc_title_wh2_dlc11_skill_node_set_cst_admiral_fem	Vampire Fleet Admiral Skills	false
character_skill_node_sets_enc_title_wh2_dlc11_skill_node_set_cst_admiral_fem_death	Vampire Fleet Admiral Skills	false
character_skill_node_sets_enc_title_wh2_dlc11_skill_node_set_cst_admiral_fem_deep	Vampire Fleet Admiral Skills	false
character_skill_node_sets_enc_title_wh2_dlc11_skill_node_set_cst_aranessa	Aranessa Saltspite Skills	false
character_skill_node_sets_enc_title_wh2_dlc11_skill_node_set_cst_cylostra	Cylostra Direfin Skills	false
character_skill_node_sets_enc_title_wh2_dlc11_skill_node_set_cst_fleet_captain	Vampire Fleet Captain (Vampires) Skills	false
character_skill_node_sets_enc_title_wh2_dlc11_skill_node_set_cst_fleet_captain_death	Vampire Fleet Captain (Death) Skills	false
character_skill_node_sets_enc_title_wh2_dlc11_skill_node_set_cst_fleet_captain_deep	Vampire Fleet Captain (Deep) Skills	false
character_skill_node_sets_enc_title_wh2_dlc11_skill_node_set_cst_ghost_paladin	Damned Paladin Skills	false
character_skill_node_sets_enc_title_wh2_dlc11_skill_node_set_cst_gunnery_wight	Gunnery Wight Skills	false
character_skill_node_sets_enc_title_wh2_dlc11_skill_node_set_cst_harkon	Luthor Harkon Skills	false
character_skill_node_sets_enc_title_wh2_dlc11_skill_node_set_cst_mourngul	Mourngul Haunter Skills	false
character_skill_node_sets_enc_title_wh2_dlc11_skill_node_set_cst_noctilus	Count Noctilus Skills	false
character_skill_node_sets_enc_title_wh2_dlc11_skill_node_set_def_lokhir	Lokhir Fellheart Skills	false
character_skill_node_sets_enc_title_wh2_dlc11_skill_node_set_vmp_bloodline_blood_dragon_lord	Blood Dragon Lord Skills	false
character_skill_node_sets_enc_title_wh2_dlc11_skill_node_set_vmp_bloodline_lahmian_lord	Lahmian Lord Skills	false
character_skill_node_sets_enc_title_wh2_dlc11_skill_node_set_vmp_bloodline_necrarch_lord	Necrarch Lord Skills	false
character_skill_node_sets_enc_title_wh2_dlc11_skill_node_set_vmp_bloodline_strigoi_lord	Strigoi Lord Skills	false
character_skill_node_sets_enc_title_wh2_dlc11_skill_node_set_vmp_bloodline_von_carstein_lord	Von Carstein Lord Skills	false
character_skill_node_sets_enc_title_wh2_dlc12_skill_node_set_ikit_claw	Ikit's Skills	false
character_skill_node_sets_enc_title_wh2_dlc12_skill_node_set_lzd_lord_kroak	Lord Kroak's Skills	false
character_skill_node_sets_enc_title_wh2_dlc12_skill_node_set_lzd_red_crested_skink_chief	Red Crested Skink Chief Skills	false
character_skill_node_sets_enc_title_wh2_dlc12_skill_node_set_lzd_red_crested_skink_chief_legendary	Red Crested Skink Chief Skills	false
character_skill_node_sets_enc_title_wh2_dlc12_skill_node_set_lzd_tehenhauin	Tehenhauin's Skills	false
character_skill_node_sets_enc_title_wh2_dlc12_skill_node_set_lzd_tiktaqto	Tiktaq'to Skills	false
character_skill_node_sets_enc_title_wh2_dlc12_skill_node_set_lzd_tlaqua_skink_chief	Skink Chief Skills	false
character_skill_node_sets_enc_title_wh2_dlc12_skill_node_set_lzd_tlaqua_skink_priest_beasts	Skink Priest (Beasts) Skills	false
character_skill_node_sets_enc_title_wh2_dlc12_skill_node_set_lzd_tlaqua_skink_priest_heavens	Skink Priest (Heavens) Skills	false
character_skill_node_sets_enc_title_wh2_dlc12_skill_node_set_skv_warlock_master	Warlock Master Skills	false
character_skill_node_sets_enc_title_wh2_dlc13_lzd_kroxigor_ancient_horde	Kroxigor Ancient Skills	false
character_skill_node_sets_enc_title_wh2_dlc13_lzd_red_crested_skink_chief_horde	Red Crested Skink Chief Skills	false
character_skill_node_sets_enc_title_wh2_dlc13_lzd_saurus_old_blood_horde	Saurus Oldblood Skills	false
character_skill_node_sets_enc_title_wh2_dlc13_lzd_slann_mage_priest_fire_horde	Slann Mage-Priest Skills (Fire)	false
character_skill_node_sets_enc_title_wh2_dlc13_lzd_slann_mage_priest_high_horde	Slann Mage-Priest Skills (High)	false
character_skill_node_sets_enc_title_wh2_dlc13_lzd_slann_mage_priest_horde	Slann Mage-Priest Skills (Light)	false
character_skill_node_sets_enc_title_wh2_dlc13_lzd_slann_mage_priest_life_horde	Slann Mage-Priest Skills (Life)	false
character_skill_node_sets_enc_title_wh2_dlc13_skill_node_set_ancient_kroxigor	Kroxigor Ancient Skills	false
character_skill_node_sets_enc_title_wh2_dlc13_skill_node_set_emp_hunter_doctor_hertwig_van_hal	Witch Hunter Skills	false
character_skill_node_sets_enc_title_wh2_dlc13_skill_node_set_emp_hunter_jorek_grimm_0	Master Engineer Skills	false
character_skill_node_sets_enc_title_wh2_dlc13_skill_node_set_emp_hunter_kalara_of_wydrioth_0	Waystalker Skills	false
character_skill_node_sets_enc_title_wh2_dlc13_skill_node_set_emp_hunter_rodrik_l_anguille_0	Paladin Skills	false
character_skill_node_sets_enc_title_wh2_dlc13_skill_node_set_gor_rok	Gor-Rok Skills	false
character_skill_node_sets_enc_title_wh2_dlc13_skill_node_set_huntsmarshal	Huntsman General Skills	false
character_skill_node_sets_enc_title_wh2_dlc13_skill_node_set_markus_wulfhart	Markus Wulfhart Skills	false
character_skill_node_sets_enc_title_wh2_dlc13_skill_node_set_nakai	Nakai Skills	false
character_skill_node_sets_enc_title_wh2_dlc14_skill_node_set_brt_henri_le_massif	Henri le Massif Skills	false
character_skill_node_sets_enc_title_wh2_dlc14_skill_node_set_brt_repanse	Repanse de Lyonesse Skills	false
character_skill_node_sets_enc_title_wh2_dlc14_skill_node_set_def_high_beastmaster	High Beastmaster Skills	false
character_skill_node_sets_enc_title_wh2_dlc14_skill_node_set_def_malus	Malus Darkblade Skills	false
character_skill_node_sets_enc_title_wh2_dlc14_skill_node_set_def_master	Master Skills	false
character_skill_node_sets_enc_title_wh2_dlc14_skill_node_set_skv_deathmaster_snikch	Deathmaster Snikch Skills	false
character_skill_node_sets_enc_title_wh2_dlc14_skill_node_set_skv_eshin_sorcerer	Eshin Sorcerer Skills	false
character_skill_node_sets_enc_title_wh2_dlc14_skill_node_set_skv_master_assassin	Master Assassin Skills	false
character_skill_node_sets_enc_title_wh2_dlc15_skill_node_set_grn_grom_the_paunch	Grom Skills	false
character_skill_node_sets_enc_title_wh2_dlc15_skill_node_set_grn_river_troll_hag	River Troll Hag Skills	false
character_skill_node_sets_enc_title_wh2_dlc15_skill_node_set_hef_archmage_beasts	Archmage (Beasts) Skills	false
character_skill_node_sets_enc_title_wh2_dlc15_skill_node_set_hef_archmage_death	Archmage (Death) Skills	false
character_skill_node_sets_enc_title_wh2_dlc15_skill_node_set_hef_archmage_fire	Archmage (Fire) Skills	false
character_skill_node_sets_enc_title_wh2_dlc15_skill_node_set_hef_archmage_heavens	Archmage (Heavens) Skills	false
character_skill_node_sets_enc_title_wh2_dlc15_skill_node_set_hef_archmage_high	Archmage (High) Skills	false
character_skill_node_sets_enc_title_wh2_dlc15_skill_node_set_hef_archmage_life	Archmage (Life) Skills	false
character_skill_node_sets_enc_title_wh2_dlc15_skill_node_set_hef_archmage_light	Archmage (Light) Skills	false
character_skill_node_sets_enc_title_wh2_dlc15_skill_node_set_hef_archmage_metal	Archmage (Metal) Skills	false
character_skill_node_sets_enc_title_wh2_dlc15_skill_node_set_hef_archmage_shadows	Archmage (Shadows) Skills	false
character_skill_node_sets_enc_title_wh2_dlc15_skill_node_set_hef_eltharion	Eltharion Skills	false
character_skill_node_sets_enc_title_wh2_dlc15_skill_node_set_hef_imrik	Imrik Skills	false
character_skill_node_sets_enc_title_wh2_dlc15_skill_node_set_hef_mage_beasts	Mage (Beasts) Skills	false
character_skill_node_sets_enc_title_wh2_dlc15_skill_node_set_hef_mage_death	Mage (Death) Skills	false
character_skill_node_sets_enc_title_wh2_dlc15_skill_node_set_hef_mage_fire	Mage (Fire) Skills	false
character_skill_node_sets_enc_title_wh2_dlc15_skill_node_set_hef_mage_metal	Mage (Metal) Skills	false
character_skill_node_sets_enc_title_wh2_dlc16_skill_node_set_skv_chieftain	Chieftain skills	false
character_skill_node_sets_enc_title_wh2_dlc16_skill_node_set_skv_ghoritch	Ghoritch Skills	false
character_skill_node_sets_enc_title_wh2_dlc16_skill_node_set_skv_packmaster	Packmaster Skills	false
character_skill_node_sets_enc_title_wh2_dlc16_skill_node_set_skv_throt_the_unclean	Throt the Unclean Skills	false
character_skill_node_sets_enc_title_wh2_dlc16_skill_node_set_wef_malicious_ancient_treeman_beasts	Malevolent Ancient Treeman (Life) Skills	false
character_skill_node_sets_enc_title_wh2_dlc16_skill_node_set_wef_malicious_ancient_treeman_life	Malevolent Ancient Treeman (Beasts) Skills	false
character_skill_node_sets_enc_title_wh2_dlc16_skill_node_set_wef_malicious_ancient_treeman_shadows	Malevolent Ancient Treeman (Shadows) Skills	false
character_skill_node_sets_enc_title_wh2_dlc16_skill_node_set_wef_malicious_branchwraith_beasts	Malevolent Branchwraith (Beasts) Skills	false
character_skill_node_sets_enc_title_wh2_dlc16_skill_node_set_wef_malicious_branchwraith_life	Malevolent Branchwraith (Life) Skills	false
character_skill_node_sets_enc_title_wh2_dlc16_skill_node_set_wef_malicious_branchwraith_shadows	Malevolent Branchwraith (Shadows) Skills	false
character_skill_node_sets_enc_title_wh2_dlc16_skill_node_set_wef_sisters_of_twilight	Sisters of Twilight Skills	false
character_skill_node_sets_enc_title_wh2_dlc16_skill_node_set_wef_spellweaver_beasts	Spellweaver Dark Skills	false
character_skill_node_sets_enc_title_wh2_dlc16_skill_node_set_wef_spellweaver_dark	Spellweaver Dark Skills	false
character_skill_node_sets_enc_title_wh2_dlc16_skill_node_set_wef_spellweaver_high	Spellweaver High Skills	false
character_skill_node_sets_enc_title_wh2_dlc16_skill_node_set_wef_spellweaver_life	Spellweaver Dark Skills	false
character_skill_node_sets_enc_title_wh2_dlc16_skill_node_set_wef_spellweaver_shadows	Spellweaver Dark Skills	false
character_skill_node_sets_enc_title_wh2_dlc17_node_set_vmp_kevon_lloydstein	Kevon LLoydstein Skills	false
character_skill_node_sets_enc_title_wh2_dlc17_skill_node_set_bst_doombull	Doombull Skills	false
character_skill_node_sets_enc_title_wh2_dlc17_skill_node_set_bst_great_bray_shaman_beast	Great Bray-Shaman (Beasts) Skills	false
character_skill_node_sets_enc_title_wh2_dlc17_skill_node_set_bst_great_bray_shaman_death	Great Bray-Shaman (Death) Skills	false
character_skill_node_sets_enc_title_wh2_dlc17_skill_node_set_bst_great_bray_shaman_shadows	Great Bray-Shaman (Shadows) Skills	false
character_skill_node_sets_enc_title_wh2_dlc17_skill_node_set_bst_great_bray_shaman_wild	Great Bray-Shaman (Wild) Skills	false
character_skill_node_sets_enc_title_wh2_dlc17_skill_node_set_bst_taurox	Taurox the Brass Bull Skills	false
character_skill_node_sets_enc_title_wh2_dlc17_skill_node_set_bst_wargor	Wargor Skills	false
character_skill_node_sets_enc_title_wh2_dlc17_skill_node_set_dwf_thane_ghost_artifact	Thane Skills 	false
character_skill_node_sets_enc_title_wh2_dlc17_skill_node_set_lzd_oxyotl	Oxyotl Skills	false
character_skill_node_sets_enc_title_wh2_dlc17_skill_node_set_lzd_skink_oracle	Skink Oracle Skills	false
character_skill_node_sets_enc_title_wh2_dlc_11_skill_node_set_cst_admiral_tech_01	Vampire Fleet Admiral Skills	false
character_skill_node_sets_enc_title_wh2_dlc_11_skill_node_set_cst_admiral_tech_02	Vampire Fleet Admiral Skills	false
character_skill_node_sets_enc_title_wh2_dlc_11_skill_node_set_cst_admiral_tech_03	Vampire Fleet Admiral Skills	false
character_skill_node_sets_enc_title_wh2_dlc_11_skill_node_set_cst_admiral_tech_04	Vampire Fleet Admiral Skills	false
character_skill_node_sets_enc_title_wh2_main_skill_node_set_chs_exalted_hero	Exalted Hero Skills	false
character_skill_node_sets_enc_title_wh2_main_skill_node_set_def_black_ark		false
character_skill_node_sets_enc_title_wh2_main_skill_node_set_def_black_ark_blessed_dread		false
character_skill_node_sets_enc_title_wh2_main_skill_node_set_def_death_hag	Death Hag Skills	false
character_skill_node_sets_enc_title_wh2_main_skill_node_set_def_dreadlord	Dreadlord Skills	false
character_skill_node_sets_enc_title_wh2_main_skill_node_set_def_dreadlord_fem	Dreadlord Skills	false
character_skill_node_sets_enc_title_wh2_main_skill_node_set_def_khainite_assassin	Khainite Assassin Skills	false
character_skill_node_sets_enc_title_wh2_main_skill_node_set_def_malekith	Malekith Skills	false
character_skill_node_sets_enc_title_wh2_main_skill_node_set_def_morathi	Morathi Skills	false
character_skill_node_sets_enc_title_wh2_main_skill_node_set_def_sorceress_dark	Sorceress (Dark) Skills	false
character_skill_node_sets_enc_title_wh2_main_skill_node_set_def_sorceress_fire	Sorceress (Fire) Skills	false
character_skill_node_sets_enc_title_wh2_main_skill_node_set_def_sorceress_shadow	Sorceress (Shadow) Skills	false
character_skill_node_sets_enc_title_wh2_main_skill_node_set_dwf_thane	Thane Skills	false
character_skill_node_sets_enc_title_wh2_main_skill_node_set_emp_captain	Empire Captain Skills	false
character_skill_node_sets_enc_title_wh2_main_skill_node_set_emp_warrior_priest	Warrior Priest Skills	false
character_skill_node_sets_enc_title_wh2_main_skill_node_set_emp_witch_hunter	Witch Hunter Skills	false
character_skill_node_sets_enc_title_wh2_main_skill_node_set_grn_goblin_big_boss	Goblin Big Boss Skills	false
character_skill_node_sets_enc_title_wh2_main_skill_node_set_hef_loremaster_of_hoeth	Loremaster of Hoeth Skills	false
character_skill_node_sets_enc_title_wh2_main_skill_node_set_hef_mage_high	Mage (High) Skills	false
character_skill_node_sets_enc_title_wh2_main_skill_node_set_hef_mage_life	Mage (Life) Skills	false
character_skill_node_sets_enc_title_wh2_main_skill_node_set_hef_mage_light	Mage (Light) Skills	false
character_skill_node_sets_enc_title_wh2_main_skill_node_set_hef_noble	Noble Skills	false
character_skill_node_sets_enc_title_wh2_main_skill_node_set_hef_prince	Prince Skills	false
character_skill_node_sets_enc_title_wh2_main_skill_node_set_hef_prince_alastar	Prince Skills	false
character_skill_node_sets_enc_title_wh2_main_skill_node_set_hef_princess	Princess Skills	false
character_skill_node_sets_enc_title_wh2_main_skill_node_set_hef_shadow_walker	Hand of the Shadow Crown Skills	false
character_skill_node_sets_enc_title_wh2_main_skill_node_set_hef_teclis	Teclis Skills	false
character_skill_node_sets_enc_title_wh2_main_skill_node_set_hef_tyrion	Tyrion Skills	false
character_skill_node_sets_enc_title_wh2_main_skill_node_set_ksl_captain	Captain Skills	false
character_skill_node_sets_enc_title_wh2_main_skill_node_set_lzd_kroq_gar	Kroq-Gar Skills	false
character_skill_node_sets_enc_title_wh2_main_skill_node_set_lzd_lord_mazdamundi	Lord Mazdamundi Skills	false
character_skill_node_sets_enc_title_wh2_main_skill_node_set_lzd_saurus_old_blood	Saurus Oldblood Skills	false
character_skill_node_sets_enc_title_wh2_main_skill_node_set_lzd_saurus_scar_veteran	Saurus Scar-Veteran Skills	false
character_skill_node_sets_enc_title_wh2_main_skill_node_set_lzd_skink_chief	Skink Chief Skills	false
character_skill_node_sets_enc_title_wh2_main_skill_node_set_lzd_skink_priest_beasts	Skink Priest (Beasts) Skills	false
character_skill_node_sets_enc_title_wh2_main_skill_node_set_lzd_skink_priest_heavens	Skink Priest (Heavens) Skills	false
character_skill_node_sets_enc_title_wh2_main_skill_node_set_lzd_slann_mage_priest	Slann Mage-Priest Skills (Light)	false
character_skill_node_sets_enc_title_wh2_main_skill_node_set_lzd_slann_mage_priest_beasts		false
character_skill_node_sets_enc_title_wh2_main_skill_node_set_lzd_slann_mage_priest_beasts_horde		false
character_skill_node_sets_enc_title_wh2_main_skill_node_set_lzd_slann_mage_priest_death		false
character_skill_node_sets_enc_title_wh2_main_skill_node_set_lzd_slann_mage_priest_death_horde		false
character_skill_node_sets_enc_title_wh2_main_skill_node_set_lzd_slann_mage_priest_fire	Slann Mage-Priest Skills (Fire)	false
character_skill_node_sets_enc_title_wh2_main_skill_node_set_lzd_slann_mage_priest_heavens		false
character_skill_node_sets_enc_title_wh2_main_skill_node_set_lzd_slann_mage_priest_heavens_horde		false
character_skill_node_sets_enc_title_wh2_main_skill_node_set_lzd_slann_mage_priest_high	Slann Mage-Priest Skills (High)	false
character_skill_node_sets_enc_title_wh2_main_skill_node_set_lzd_slann_mage_priest_life	Slann Mage-Priest Skills (Life)	false
character_skill_node_sets_enc_title_wh2_main_skill_node_set_lzd_slann_mage_priest_metal		false
character_skill_node_sets_enc_title_wh2_main_skill_node_set_lzd_slann_mage_priest_metal_horde		false
character_skill_node_sets_enc_title_wh2_main_skill_node_set_lzd_slann_mage_priest_shadows		false
character_skill_node_sets_enc_title_wh2_main_skill_node_set_lzd_slann_mage_priest_shadows_horde		false
character_skill_node_sets_enc_title_wh2_main_skill_node_set_skv_assassin	Assassin Skills	false
character_skill_node_sets_enc_title_wh2_main_skill_node_set_skv_grey_seer_plague	Grey Seer (Plague) Skills	false
character_skill_node_sets_enc_title_wh2_main_skill_node_set_skv_grey_seer_ruin	Grey Seer (Ruin) Skills	false
character_skill_node_sets_enc_title_wh2_main_skill_node_set_skv_lord_skrolk	Lord Skrolk Skills	false
character_skill_node_sets_enc_title_wh2_main_skill_node_set_skv_plague_priest	Plague Priest Skills	false
character_skill_node_sets_enc_title_wh2_main_skill_node_set_skv_plague_priest_ritual	Plague Priest Skills	false
character_skill_node_sets_enc_title_wh2_main_skill_node_set_skv_queek_headtaker	Queek Headtaker Skills	false
character_skill_node_sets_enc_title_wh2_main_skill_node_set_skv_warlock_engineer	Warlock Engineer Skills	false
character_skill_node_sets_enc_title_wh2_main_skill_node_set_skv_warlock_engineer_ritual	Warlock Engineer Skills	false
character_skill_node_sets_enc_title_wh2_main_skill_node_set_skv_warlord	Warlord Skills	false
character_skill_node_sets_enc_title_wh2_main_skill_node_set_teb_captain	Captain Skills	false
character_skill_node_sets_enc_title_wh2_main_skill_node_set_vmp_banshee	Banshee Skills	false
character_skill_node_sets_enc_title_wh2_main_skill_node_set_vmp_wight_king	Wight King Skills	false
character_skill_node_sets_enc_title_wh2_pro07_skill_node_set_emp_amethyst_wizard	Amethyst Wizard Skills	false
character_skill_node_sets_enc_title_wh2_pro08_skill_node_neu_felix	Felix Skills	false
character_skill_node_sets_enc_title_wh2_pro08_skill_node_neu_gotrek	Gotrek Skills	false
character_skill_node_sets_enc_title_wh2_pro09_skill_node_set_grn_black_orc_big_boss	Black Orc Big Boss Skills	false
character_skill_node_sets_enc_title_wh2_twa02_skill_node_set_wef_glade_captain	Glade Captain Skills	false
character_skill_node_sets_enc_title_wh2_twa03_skill_node_set_def_rakarth	Rakarth Skills	false
character_skill_node_sets_enc_title_wh3_dlc20_chs_exalted_hero_mkho		false
character_skill_node_sets_enc_title_wh3_dlc20_chs_exalted_hero_mnur		false
character_skill_node_sets_enc_title_wh3_dlc20_chs_lord_mkho		false
character_skill_node_sets_enc_title_wh3_dlc20_chs_lord_msla		false
character_skill_node_sets_enc_title_wh3_dlc20_chs_sorcerer_lord_death_mnur		false
character_skill_node_sets_enc_title_wh3_dlc20_chs_sorcerer_lord_metal_mtze		false
character_skill_node_sets_enc_title_wh3_dlc20_chs_sorcerer_lord_nurgle_mnur		false
character_skill_node_sets_enc_title_wh3_dlc20_chs_sorcerer_lord_tzeentch_mtze		false
character_skill_node_sets_enc_title_wh3_dlc20_chs_sorcerer_metal_mtze		false
character_skill_node_sets_enc_title_wh3_dlc20_chs_sorcerer_shadows_msla		false
character_skill_node_sets_enc_title_wh3_dlc20_chs_sorcerer_slaanesh_msla		false
character_skill_node_sets_enc_title_wh3_dlc20_chs_sorcerer_tzeentch_mtze		false
character_skill_node_sets_enc_title_wh3_dlc20_skill_node_set_chs_daemon_prince_khorne		false
character_skill_node_sets_enc_title_wh3_dlc20_skill_node_set_chs_daemon_prince_nurgle		false
character_skill_node_sets_enc_title_wh3_dlc20_skill_node_set_chs_daemon_prince_slaanesh		false
character_skill_node_sets_enc_title_wh3_dlc20_skill_node_set_chs_daemon_prince_tzeentch		false
character_skill_node_sets_enc_title_wh3_dlc20_skill_node_set_chs_daemon_prince_undivided		false
character_skill_node_sets_enc_title_wh3_dlc20_skill_node_set_kho_valkia		false
character_skill_node_sets_enc_title_wh3_dlc20_skill_node_set_nur_festus		false
character_skill_node_sets_enc_title_wh3_dlc20_skill_node_set_sla_azazel		false
character_skill_node_sets_enc_title_wh3_dlc20_skill_node_set_tze_vilitch		false
character_skill_node_sets_enc_title_wh3_dlc23_skill_node_set_chd_astragoth		false
character_skill_node_sets_enc_title_wh3_dlc23_skill_node_set_chd_bull_centaur_taurruk		false
character_skill_node_sets_enc_title_wh3_dlc23_skill_node_set_chd_daemonsmith_sorcerer_death		false
character_skill_node_sets_enc_title_wh3_dlc23_skill_node_set_chd_daemonsmith_sorcerer_fire		false
character_skill_node_sets_enc_title_wh3_dlc23_skill_node_set_chd_daemonsmith_sorcerer_hashut		false
character_skill_node_sets_enc_title_wh3_dlc23_skill_node_set_chd_daemonsmith_sorcerer_metal		false
character_skill_node_sets_enc_title_wh3_dlc23_skill_node_set_chd_drazhoath		false
character_skill_node_sets_enc_title_wh3_dlc23_skill_node_set_chd_gorduz_backstabber		false
character_skill_node_sets_enc_title_wh3_dlc23_skill_node_set_chd_infernal_castellan		false
character_skill_node_sets_enc_title_wh3_dlc23_skill_node_set_chd_lord_convoy_overseer		false
character_skill_node_sets_enc_title_wh3_dlc23_skill_node_set_chd_overseer		false
character_skill_node_sets_enc_title_wh3_dlc23_skill_node_set_chd_sorcerer_prophet_death		false
character_skill_node_sets_enc_title_wh3_dlc23_skill_node_set_chd_sorcerer_prophet_fire		false
character_skill_node_sets_enc_title_wh3_dlc23_skill_node_set_chd_sorcerer_prophet_hashut		false
character_skill_node_sets_enc_title_wh3_dlc23_skill_node_set_chd_sorcerer_prophet_metal		false
character_skill_node_sets_enc_title_wh3_dlc23_skill_node_set_chd_zhatan		false
character_skill_node_sets_enc_title_wh3_dlc23_skill_node_set_ksl_ulrika		false
character_skill_node_sets_enc_title_wh3_dlc24_skill_node_set_chs_exalted_hero_mtze		false
character_skill_node_sets_enc_title_wh3_dlc24_skill_node_set_chs_lord_mtze		false
character_skill_node_sets_enc_title_wh3_dlc24_skill_node_set_cth_celestial_general_yang		false
character_skill_node_sets_enc_title_wh3_dlc24_skill_node_set_cth_celestial_general_yin		false
character_skill_node_sets_enc_title_wh3_dlc24_skill_node_set_cth_gate_master		false
character_skill_node_sets_enc_title_wh3_dlc24_skill_node_set_cth_saytang_the_watcher		false
character_skill_node_sets_enc_title_wh3_dlc24_skill_node_set_cth_yuan_bo		false
character_skill_node_sets_enc_title_wh3_dlc24_skill_node_set_ksl_druzhina		false
character_skill_node_sets_enc_title_wh3_dlc24_skill_node_set_ksl_hag_witch_beasts		false
character_skill_node_sets_enc_title_wh3_dlc24_skill_node_set_ksl_hag_witch_death		false
character_skill_node_sets_enc_title_wh3_dlc24_skill_node_set_ksl_hag_witch_hag		false
character_skill_node_sets_enc_title_wh3_dlc24_skill_node_set_ksl_hag_witch_shadows		false
character_skill_node_sets_enc_title_wh3_dlc24_skill_node_set_ksl_mother_ostankya		false
character_skill_node_sets_enc_title_wh3_dlc24_skill_node_set_ksl_the_golden_knight		false
character_skill_node_sets_enc_title_wh3_dlc24_skill_node_set_tze_aekold_helbrass		false
character_skill_node_sets_enc_title_wh3_dlc24_skill_node_set_tze_blue_scribes		false
character_skill_node_sets_enc_title_wh3_dlc24_skill_node_set_tze_exalted_lord_of_change_metal_locked_army		false
character_skill_node_sets_enc_title_wh3_dlc24_skill_node_set_tze_exalted_lord_of_change_tzeentch_locked_army		false
character_skill_node_sets_enc_title_wh3_dlc24_skill_node_set_tze_the_changeling		false
character_skill_node_sets_enc_title_wh3_dlc24_skill_node_set_tze_the_changeling_cultist_special		false
character_skill_node_sets_enc_title_wh3_dlc25_chs_lord_mnur		false
character_skill_node_sets_enc_title_wh3_dlc25_chs_sorcerer_death_mnur		false
character_skill_node_sets_enc_title_wh3_dlc25_chs_sorcerer_nurgle_mnur		false
character_skill_node_sets_enc_title_wh3_dlc25_dwf_lord_mikael_leadstrong	Mikael Leadstrong	false
character_skill_node_sets_enc_title_wh3_dlc25_skill_node_set_dwf_daemon_slayer		false
character_skill_node_sets_enc_title_wh3_dlc25_skill_node_set_dwf_dragon_slayer		false
character_skill_node_sets_enc_title_wh3_dlc25_skill_node_set_dwf_garagrim_ironfist		false
character_skill_node_sets_enc_title_wh3_dlc25_skill_node_set_dwf_malakai_makaisson		false
character_skill_node_sets_enc_title_wh3_dlc25_skill_node_set_emp_elspeth_von_draken		false
character_skill_node_sets_enc_title_wh3_dlc25_skill_node_set_emp_engineer		false
character_skill_node_sets_enc_title_wh3_dlc25_skill_node_set_emp_gold_wizard		false
character_skill_node_sets_enc_title_wh3_dlc25_skill_node_set_emp_master_engineer		false
character_skill_node_sets_enc_title_wh3_dlc25_skill_node_set_emp_theodore_bruckner		false
character_skill_node_sets_enc_title_wh3_dlc25_skill_node_set_nur_bray_shaman_wild_chieftain		false
character_skill_node_sets_enc_title_wh3_dlc25_skill_node_set_nur_castellan_chieftain		false
character_skill_node_sets_enc_title_wh3_dlc25_skill_node_set_nur_epidemius		false
character_skill_node_sets_enc_title_wh3_dlc25_skill_node_set_nur_exalted_hero_chieftain		false
character_skill_node_sets_enc_title_wh3_dlc25_skill_node_set_nur_fimir_balefiend_shadow_chieftain		false
character_skill_node_sets_enc_title_wh3_dlc25_skill_node_set_nur_kayzk_the_befouled		false
character_skill_node_sets_enc_title_wh3_dlc25_skill_node_set_nur_skin_wolf_werekin_chieftain		false
character_skill_node_sets_enc_title_wh3_dlc25_skill_node_set_nur_tamurkhan		false
character_skill_node_sets_enc_title_wh3_main_ie_skill_node_set_nor_burplesmirk_spewpit	Burplesmirk Spewpit Skills	false
character_skill_node_sets_enc_title_wh3_main_ie_skill_node_set_nor_killgore_slaymaim	Killgore Slaymaim Skills	false
character_skill_node_sets_enc_title_wh3_main_pro_skill_node_set_kho_cultist		false
character_skill_node_sets_enc_title_wh3_main_pro_skill_node_set_ksl_boyar		false
character_skill_node_sets_enc_title_wh3_main_pro_skill_node_set_ksl_frost_maiden_ice		false
character_skill_node_sets_enc_title_wh3_main_pro_skill_node_set_ksl_patriarch		false
character_skill_node_sets_enc_title_wh3_main_pro_skill_node_set_tze_cultist		false
character_skill_node_sets_enc_title_wh3_main_prologue_skill_node_set_kho_bloodthirster		false
character_skill_node_sets_enc_title_wh3_main_prologue_skill_node_set_nor_slavin		false
character_skill_node_sets_enc_title_wh3_main_skill_node_set_cth_alchemist		false
character_skill_node_sets_enc_title_wh3_main_skill_node_set_cth_astromancer		false
character_skill_node_sets_enc_title_wh3_main_skill_node_set_cth_dragon_blooded_shugengan_yang		false
character_skill_node_sets_enc_title_wh3_main_skill_node_set_cth_dragon_blooded_shugengan_yin		false
character_skill_node_sets_enc_title_wh3_main_skill_node_set_cth_lord_caravan_master		false
character_skill_node_sets_enc_title_wh3_main_skill_node_set_cth_lord_magistrate_yang		false
character_skill_node_sets_enc_title_wh3_main_skill_node_set_cth_lord_magistrate_yin		false
character_skill_node_sets_enc_title_wh3_main_skill_node_set_cth_miao_ying		false
character_skill_node_sets_enc_title_wh3_main_skill_node_set_cth_zhao_ming		false
character_skill_node_sets_enc_title_wh3_main_skill_node_set_dae_cha_be_lakor_0		false
character_skill_node_sets_enc_title_wh3_main_skill_node_set_dae_cha_be_lakor_survival		false
character_skill_node_sets_enc_title_wh3_main_skill_node_set_dae_daemon_prince		false
character_skill_node_sets_enc_title_wh3_main_skill_node_set_kho_bloodreaper		false
character_skill_node_sets_enc_title_wh3_main_skill_node_set_kho_cult_magus		false
character_skill_node_sets_enc_title_wh3_main_skill_node_set_kho_cultist		false
character_skill_node_sets_enc_title_wh3_main_skill_node_set_kho_exalted_bloodthirster		false
character_skill_node_sets_enc_title_wh3_main_skill_node_set_kho_herald_of_khorne		false
character_skill_node_sets_enc_title_wh3_main_skill_node_set_kho_skarbrand		false
character_skill_node_sets_enc_title_wh3_main_skill_node_set_ksl_ataman		false
character_skill_node_sets_enc_title_wh3_main_skill_node_set_ksl_boris		false
character_skill_node_sets_enc_title_wh3_main_skill_node_set_ksl_boyar		false
character_skill_node_sets_enc_title_wh3_main_skill_node_set_ksl_frost_maiden_ice		false
character_skill_node_sets_enc_title_wh3_main_skill_node_set_ksl_frost_maiden_tempest		false
character_skill_node_sets_enc_title_wh3_main_skill_node_set_ksl_ice_witch_ice		false
character_skill_node_sets_enc_title_wh3_main_skill_node_set_ksl_ice_witch_tempest		false
character_skill_node_sets_enc_title_wh3_main_skill_node_set_ksl_katarin		false
character_skill_node_sets_enc_title_wh3_main_skill_node_set_ksl_kostaltyn		false
character_skill_node_sets_enc_title_wh3_main_skill_node_set_ksl_patriarch		false
character_skill_node_sets_enc_title_wh3_main_skill_node_set_nur_cult_magus		false
character_skill_node_sets_enc_title_wh3_main_skill_node_set_nur_cultist		false
character_skill_node_sets_enc_title_wh3_main_skill_node_set_nur_exalted_great_unclean_one_death		false
character_skill_node_sets_enc_title_wh3_main_skill_node_set_nur_exalted_great_unclean_one_nurgle		false
character_skill_node_sets_enc_title_wh3_main_skill_node_set_nur_herald_of_nurgle_death		false
character_skill_node_sets_enc_title_wh3_main_skill_node_set_nur_herald_of_nurgle_nurgle		false
character_skill_node_sets_enc_title_wh3_main_skill_node_set_nur_kugath		false
character_skill_node_sets_enc_title_wh3_main_skill_node_set_nur_plague_cultist		false
character_skill_node_sets_enc_title_wh3_main_skill_node_set_nur_plagueridden_death		false
character_skill_node_sets_enc_title_wh3_main_skill_node_set_nur_plagueridden_nurgle		false
character_skill_node_sets_enc_title_wh3_main_skill_node_set_ogr_butcher_beasts		false
character_skill_node_sets_enc_title_wh3_main_skill_node_set_ogr_butcher_great_maw		false
character_skill_node_sets_enc_title_wh3_main_skill_node_set_ogr_firebelly		false
character_skill_node_sets_enc_title_wh3_main_skill_node_set_ogr_greasus_goldtooth		false
character_skill_node_sets_enc_title_wh3_main_skill_node_set_ogr_hunter		false
character_skill_node_sets_enc_title_wh3_main_skill_node_set_ogr_skrag_the_slaughterer		false
character_skill_node_sets_enc_title_wh3_main_skill_node_set_ogr_slaughtermaster_beasts		false
character_skill_node_sets_enc_title_wh3_main_skill_node_set_ogr_slaughtermaster_great_maw		false
character_skill_node_sets_enc_title_wh3_main_skill_node_set_ogr_tyrant		false
character_skill_node_sets_enc_title_wh3_main_skill_node_set_sla_alluress_shadow		false
character_skill_node_sets_enc_title_wh3_main_skill_node_set_sla_alluress_slaanesh		false
character_skill_node_sets_enc_title_wh3_main_skill_node_set_sla_cult_magus		false
character_skill_node_sets_enc_title_wh3_main_skill_node_set_sla_cultist		false
character_skill_node_sets_enc_title_wh3_main_skill_node_set_sla_exalted_keeper_of_secrets_shadow		false
character_skill_node_sets_enc_title_wh3_main_skill_node_set_sla_exalted_keeper_of_secrets_slaanesh		false
character_skill_node_sets_enc_title_wh3_main_skill_node_set_sla_herald_of_slaanesh_shadow		false
character_skill_node_sets_enc_title_wh3_main_skill_node_set_sla_herald_of_slaanesh_slaanesh		false
character_skill_node_sets_enc_title_wh3_main_skill_node_set_sla_nkari		false
character_skill_node_sets_enc_title_wh3_main_skill_node_set_tze_cult_magus		false
character_skill_node_sets_enc_title_wh3_main_skill_node_set_tze_cultist		false
character_skill_node_sets_enc_title_wh3_main_skill_node_set_tze_exalted_lord_of_change_metal		false
character_skill_node_sets_enc_title_wh3_main_skill_node_set_tze_exalted_lord_of_change_tzeentch		false
character_skill_node_sets_enc_title_wh3_main_skill_node_set_tze_herald_of_tzeentch_metal		false
character_skill_node_sets_enc_title_wh3_main_skill_node_set_tze_herald_of_tzeentch_tzeentch		false
character_skill_node_sets_enc_title_wh3_main_skill_node_set_tze_iridescent_horror_metal		false
character_skill_node_sets_enc_title_wh3_main_skill_node_set_tze_iridescent_horror_tzeentch		false
character_skill_node_sets_enc_title_wh3_main_skill_node_set_tze_kairos		false
character_skill_node_sets_enc_title_wh3_pro10_skill_node_set_chs_daemon_prince_tzeentch		false
character_skill_node_sets_enc_title_wh3_pro10_skill_node_set_tze_cultist		false
character_skill_node_sets_enc_title_wh3_pro11_chs_cha_harald_hammerstorm	Harald Hammerstorm's Skills	false
character_skill_node_sets_enc_title_wh3_pro12_kho_cha_karanak	[PH] Karanak	false
character_skill_node_sets_enc_title_wh3_prologue_skill_node_set_ksl_test		false
character_skill_node_sets_enc_title_wh_dlc03_skill_node_set_bst_beastlord	Beast Lord Skills	false
character_skill_node_sets_enc_title_wh_dlc03_skill_node_set_bst_bray_shaman_beast	Bray-Shaman (Beasts) Skills	false
character_skill_node_sets_enc_title_wh_dlc03_skill_node_set_bst_bray_shaman_death	Bray-Shaman (Death) Skills	false
character_skill_node_sets_enc_title_wh_dlc03_skill_node_set_bst_bray_shaman_shadows	Bray-Shaman (Shadows) Skills	false
character_skill_node_sets_enc_title_wh_dlc03_skill_node_set_bst_bray_shaman_wild	Bray-Shaman (Wild) Skills	false
character_skill_node_sets_enc_title_wh_dlc03_skill_node_set_bst_gorebull	Gorebull Skills	false
character_skill_node_sets_enc_title_wh_dlc03_skill_node_set_bst_khazrak	Khazrak Skills	false
character_skill_node_sets_enc_title_wh_dlc03_skill_node_set_bst_malagor	Malagor Skills	false
character_skill_node_sets_enc_title_wh_dlc03_skill_node_set_bst_morghur	Morghur Skills	false
character_skill_node_sets_enc_title_wh_dlc03_skill_node_set_emp_amber_wizard	Amber Wizard Skills	false
character_skill_node_sets_enc_title_wh_dlc03_skill_node_set_emp_boris_todbringer	Boris Todbringer Skills	false
character_skill_node_sets_enc_title_wh_dlc04_skill_node_set_emp_arch_lector	Arch Lector Skills	false
character_skill_node_sets_enc_title_wh_dlc04_skill_node_set_emp_volkmar	Volkmar Skills 	false
character_skill_node_sets_enc_title_wh_dlc04_skill_node_set_vmp_helman_ghorst	Helman Ghorst Skills	false
character_skill_node_sets_enc_title_wh_dlc04_skill_node_set_vmp_strigoi_ghoul_king	Strigoi Ghoul King Skills	false
character_skill_node_sets_enc_title_wh_dlc04_skill_node_set_vmp_vlad_von_carstein	Vlad von Carstein Skills	false
character_skill_node_sets_enc_title_wh_dlc04_skill_node_set_vmp_vlad_von_carstein_hero	Vlad von Carstein Skills	false
character_skill_node_sets_enc_title_wh_dlc05_skill_node_set_grey_wizard	Grey Wizard Skills	false
character_skill_node_sets_enc_title_wh_dlc05_skill_node_set_jade_wizard	Jade Wizard Skills	false
character_skill_node_sets_enc_title_wh_dlc05_skill_node_set_vmp_red_duke	Red Duke Skills	false
character_skill_node_sets_enc_title_wh_dlc05_skill_node_set_vmp_vampire_shadow	Vampire (Shadow) Skills	false
character_skill_node_sets_enc_title_wh_dlc05_skill_node_set_wef_ancient_treeman	Ancient Treeman Skills	false
character_skill_node_sets_enc_title_wh_dlc05_skill_node_set_wef_branchwraith	Branchwraith Skills	false
character_skill_node_sets_enc_title_wh_dlc05_skill_node_set_wef_durthu	Durthu Skills	false
character_skill_node_sets_enc_title_wh_dlc05_skill_node_set_wef_glade_lord	Glade Lord Skills	false
character_skill_node_sets_enc_title_wh_dlc05_skill_node_set_wef_glade_lord_fem	Glade Lord Skills	false
character_skill_node_sets_enc_title_wh_dlc05_skill_node_set_wef_orion	Orion Skills	false
character_skill_node_sets_enc_title_wh_dlc05_skill_node_set_wef_spellsinger_beasts	Spellsinger Beasts Skills	false
character_skill_node_sets_enc_title_wh_dlc05_skill_node_set_wef_spellsinger_life	Spellsinger Life Skills	false
character_skill_node_sets_enc_title_wh_dlc05_skill_node_set_wef_spellsinger_shadow	Spellsinger Shadow Skills	false
character_skill_node_sets_enc_title_wh_dlc05_skill_node_set_wef_waystalker	Waystalker Skills	false
character_skill_node_sets_enc_title_wh_dlc06_skill_node_set_dwf_belegar	Belegar Skills	false
character_skill_node_sets_enc_title_wh_dlc06_skill_node_set_dwf_master_engineer_ghost	Master Engineer Skills	false
character_skill_node_sets_enc_title_wh_dlc06_skill_node_set_dwf_runelord	Runelord Skills	false
character_skill_node_sets_enc_title_wh_dlc06_skill_node_set_dwf_runesmith_ghost	Runesmith Skills	false
character_skill_node_sets_enc_title_wh_dlc06_skill_node_set_dwf_thane_ghost_1	Thane Skills 	false
character_skill_node_sets_enc_title_wh_dlc06_skill_node_set_dwf_thane_ghost_2	Thane Skills 	false
character_skill_node_sets_enc_title_wh_dlc06_skill_node_set_grn_night_goblin_warboss	Night Goblin Warboss Skills	false
character_skill_node_sets_enc_title_wh_dlc06_skill_node_set_grn_skarsnik	Skarsnik Skills	false
character_skill_node_sets_enc_title_wh_dlc06_skill_node_set_grn_wurrzag_da_great_prophet	Wurrzag da Great Prophet	false
character_skill_node_sets_enc_title_wh_dlc07_skill_node_set_brt_alberic	Alberic Skills	false
character_skill_node_sets_enc_title_wh_dlc07_skill_node_set_brt_damsel_beasts	Damsel Skills	false
character_skill_node_sets_enc_title_wh_dlc07_skill_node_set_brt_damsel_life	Damsel Skills	false
character_skill_node_sets_enc_title_wh_dlc07_skill_node_set_brt_fay_enchantress	Fay Enchantress Skills	false
character_skill_node_sets_enc_title_wh_dlc07_skill_node_set_brt_green_knight	Green Knight Skills	false
character_skill_node_sets_enc_title_wh_dlc07_skill_node_set_brt_paladin	Paladin Skills	false
character_skill_node_sets_enc_title_wh_dlc07_skill_node_set_brt_prophetess_beast	Prophetess (Beast) Skills 	false
character_skill_node_sets_enc_title_wh_dlc07_skill_node_set_brt_prophetess_heavens	Prophetess (Heaven) Skills 	false
character_skill_node_sets_enc_title_wh_dlc07_skill_node_set_brt_prophetess_life	Prophetess (Life) Skills	false
character_skill_node_sets_enc_title_wh_dlc07_skill_node_set_chs_sorcerer_lord_shadow	Chaos Sorcerer Lord (Shadow) Skills	false
character_skill_node_sets_enc_title_wh_dlc07_skill_node_set_chs_sorcerer_shadow	Chaos Sorcerer (Shadow) Skills	false
character_skill_node_sets_enc_title_wh_dlc08_skill_node_set_chs_challenger_khorne	Chaos Challengers Skills	false
character_skill_node_sets_enc_title_wh_dlc08_skill_node_set_chs_challenger_nurgle	Chaos Challengers Skills	false
character_skill_node_sets_enc_title_wh_dlc08_skill_node_set_chs_challenger_slaanesh	Chaos Challengers Skills	false
character_skill_node_sets_enc_title_wh_dlc08_skill_node_set_chs_challenger_tzeentch	Chaos Challengers Skills	false
character_skill_node_sets_enc_title_wh_dlc08_skill_node_set_nor_arzik	Arzik Skills	false
character_skill_node_sets_enc_title_wh_dlc08_skill_node_set_nor_fimir_balefiend_fire	Fimir Balefiend (Fire) Skills	false
character_skill_node_sets_enc_title_wh_dlc08_skill_node_set_nor_fimir_balefiend_shadow	Fimir Balefiend (Shadows) Skills	false
character_skill_node_sets_enc_title_wh_dlc08_skill_node_set_nor_kihar	Kihar Skills	false
character_skill_node_sets_enc_title_wh_dlc08_skill_node_set_nor_marauder_chieftain	Marauder Chieftan Skills	false
character_skill_node_sets_enc_title_wh_dlc08_skill_node_set_nor_shaman_sorcerer_death	Shaman-Sorcerer (Death) Skills	false
character_skill_node_sets_enc_title_wh_dlc08_skill_node_set_nor_shaman_sorcerer_fire	Shaman-Sorcerer (Fire) Skills	false
character_skill_node_sets_enc_title_wh_dlc08_skill_node_set_nor_shaman_sorcerer_metal	Shaman-Sorcerer (Metal) Skills	false
character_skill_node_sets_enc_title_wh_dlc08_skill_node_set_nor_skin_wolf_werekin	Skin Wolf Werekin Skills	false
character_skill_node_sets_enc_title_wh_dlc08_skill_node_set_nor_throgg	Throgg Skills	false
character_skill_node_sets_enc_title_wh_dlc08_skill_node_set_nor_wulfrik	Wulfrik Skills	false
character_skill_node_sets_enc_title_wh_dlc16_skill_node_set_wef_ariel	Ariel Skills	false
character_skill_node_sets_enc_title_wh_dlc16_skill_node_set_wef_coeddil	Coeddil Skills	false
character_skill_node_sets_enc_title_wh_dlc16_skill_node_set_wef_drycha	Drycha Skills	false
character_skill_node_sets_enc_title_wh_dlc17_skill_node_set_dwf_thorek	Thorek Ironbrow Skills	false
character_skill_node_sets_enc_title_wh_main_skill_node_set_all_engineer	Master Engineer Hero Skills	false
character_skill_node_sets_enc_title_wh_main_skill_node_set_all_runesmith	Runesmith Hero Skills	false
character_skill_node_sets_enc_title_wh_main_skill_node_set_brt_damsel	Damsel Skills	false
character_skill_node_sets_enc_title_wh_main_skill_node_set_brt_lord	Bretonnia Lord Skills	false
character_skill_node_sets_enc_title_wh_main_skill_node_set_brt_louen	King Louen Leoncoeur Skills	false
character_skill_node_sets_enc_title_wh_main_skill_node_set_chs_archaon	Archaon the Everchosen Skills	false
character_skill_node_sets_enc_title_wh_main_skill_node_set_chs_chaos_sorcerer_death	Chaos Sorcerer (Death) Skills	false
character_skill_node_sets_enc_title_wh_main_skill_node_set_chs_chaos_sorcerer_fire	Chaos Sorcerer (Fire) Skills	false
character_skill_node_sets_enc_title_wh_main_skill_node_set_chs_chaos_sorcerer_metal	Chaos Sorcerer (Metal) Skills	false
character_skill_node_sets_enc_title_wh_main_skill_node_set_chs_kholek	Kholek Suneater Skills	false
character_skill_node_sets_enc_title_wh_main_skill_node_set_chs_lord	Chaos Lord Skills	false
character_skill_node_sets_enc_title_wh_main_skill_node_set_chs_lord_of_change	Lord of Change Skills	false
character_skill_node_sets_enc_title_wh_main_skill_node_set_chs_sigvald	Prince Sigvald the Magnificent Skills	false
character_skill_node_sets_enc_title_wh_main_skill_node_set_chs_sorcerer_lord_death	Chaos Sorcerer Lord (Death) Skills	false
character_skill_node_sets_enc_title_wh_main_skill_node_set_chs_sorcerer_lord_fire	Chaos Sorcerer Lord (Fire) Skills	false
character_skill_node_sets_enc_title_wh_main_skill_node_set_chs_sorcerer_lord_metal	Chaos Sorcerer Lord (Metal) Skills	false
character_skill_node_sets_enc_title_wh_main_skill_node_set_dwf_lord	Dwarf Lord Skills	false
character_skill_node_sets_enc_title_wh_main_skill_node_set_dwf_thorgrim	Thorgrim Grudgebearer Skills	false
character_skill_node_sets_enc_title_wh_main_skill_node_set_dwf_ungrim	Ungrim Ironfist Skills	false
character_skill_node_sets_enc_title_wh_main_skill_node_set_emp_balthasar	Balthasar Gelt Skills	false
character_skill_node_sets_enc_title_wh_main_skill_node_set_emp_bright_wizard	Bright Wizard Skills	false
character_skill_node_sets_enc_title_wh_main_skill_node_set_emp_celestial_wizard	Celestial Wizard Skills	false
character_skill_node_sets_enc_title_wh_main_skill_node_set_emp_general	General of the Empire Skills	false
character_skill_node_sets_enc_title_wh_main_skill_node_set_emp_karl_franz	Karl Franz Skills	false
character_skill_node_sets_enc_title_wh_main_skill_node_set_emp_light_wizard	Light Wizard Skills	false
character_skill_node_sets_enc_title_wh_main_skill_node_set_grn_azhag	Azhag the Slaughterer Skills	false
character_skill_node_sets_enc_title_wh_main_skill_node_set_grn_goblin_great_shaman	Goblin Great Shaman Skills	false
character_skill_node_sets_enc_title_wh_main_skill_node_set_grn_grimgor	Grimgor Ironhide Skills	false
character_skill_node_sets_enc_title_wh_main_skill_node_set_grn_night_goblin_shaman	Night Goblin Shaman Skills	false
character_skill_node_sets_enc_title_wh_main_skill_node_set_grn_orc_shaman	Orc Shaman Skills	false
character_skill_node_sets_enc_title_wh_main_skill_node_set_grn_orc_warboss	Orc Warboss Skills	false
character_skill_node_sets_enc_title_wh_main_skill_node_set_nor_chaos_sorcerer_metal	Chaos Sorcerer (Metal) Skills	false
character_skill_node_sets_enc_title_wh_main_skill_node_set_nor_sorcerer_lord_metal	Chaos Sorcerer Lord (Metal) Skills	false
character_skill_node_sets_enc_title_wh_main_skill_node_set_oglok	Orc Warboss Skills	false
character_skill_node_sets_enc_title_wh_main_skill_node_set_raknik	Goblin Great Shaman Skills	false
character_skill_node_sets_enc_title_wh_main_skill_node_set_teb_bright_wizard	Bright Wizard Skills	false
character_skill_node_sets_enc_title_wh_main_skill_node_set_teb_general	Tilea, Estalia & Border Princes General Skills	false
character_skill_node_sets_enc_title_wh_main_skill_node_set_vmp_heinrich	Heinrich Kemmler Skills	false
character_skill_node_sets_enc_title_wh_main_skill_node_set_vmp_lord	Vampire Lord Skills	false
character_skill_node_sets_enc_title_wh_main_skill_node_set_vmp_mannfred	Mannfred von Carstein Skills	false
character_skill_node_sets_enc_title_wh_main_skill_node_set_vmp_master_necromancer	Master Necromancer Skills	false
character_skill_node_sets_enc_title_wh_main_skill_node_set_vmp_necromancer	Necromancer Skills	false
character_skill_node_sets_enc_title_wh_main_skill_node_set_vmp_vampire	Vampire Skills	false
character_skill_node_sets_enc_title_wh_pro01_skill_node_set_dwf_grombrindal	Grombrindal Skills	false
character_skill_node_sets_enc_title_wh_pro02_skill_node_set_vmp_isabella_von_carstein	Isabella von Carstein Skills	false
character_skill_node_sets_enc_title_wh_pro02_skill_node_set_vmp_isabella_von_carstein_hero	Isabella von Carstein Skills	false
