key	text	tooltip
#Loc;1;text/db/initiatives__.loc		
initiatives_localised_description_wh3_dlc20_character_initiative_ascend_lord_to_daemon_prince_khorne	Character must reach rank 20.	false
initiatives_localised_description_wh3_dlc20_character_initiative_ascend_lord_to_daemon_prince_khorne_from_und	Character must reach rank 30.	false
initiatives_localised_description_wh3_dlc20_character_initiative_ascend_lord_to_daemon_prince_nurgle	Character must reach rank 20.	false
initiatives_localised_description_wh3_dlc20_character_initiative_ascend_lord_to_daemon_prince_nurgle_from_und	Character must reach rank 30.	false
initiatives_localised_description_wh3_dlc20_character_initiative_ascend_lord_to_daemon_prince_slaanesh	Character must reach rank 20.	false
initiatives_localised_description_wh3_dlc20_character_initiative_ascend_lord_to_daemon_prince_slaanesh_from_und	Character must reach rank 30.	false
initiatives_localised_description_wh3_dlc20_character_initiative_ascend_lord_to_daemon_prince_tzeentch	Character must reach rank 20.	false
initiatives_localised_description_wh3_dlc20_character_initiative_ascend_lord_to_daemon_prince_tzeentch_from_und	Character must reach rank 30.	false
initiatives_localised_description_wh3_dlc20_character_initiative_ascend_lord_to_daemon_prince_undivided	Character must reach rank 30.	false
initiatives_localised_description_wh3_dlc20_character_initiative_chs_chaos_lord_kho_01	Win 5 battles.	false
initiatives_localised_description_wh3_dlc20_character_initiative_chs_chaos_lord_kho_02	Win a battle against multiple armies.	false
initiatives_localised_description_wh3_dlc20_character_initiative_chs_chaos_lord_kho_03	Win a battle with 2000 kills.	false
initiatives_localised_description_wh3_dlc20_character_initiative_chs_chaos_lord_kho_04	Win a battle against an army with 3 characters.	false
initiatives_localised_description_wh3_dlc20_character_initiative_chs_chaos_lord_kho_05	Win a battle against an army containing 5 missile units.	false
initiatives_localised_description_wh3_dlc20_character_initiative_chs_chaos_lord_kho_06	Lose a battle and survive.	false
initiatives_localised_description_wh3_dlc20_character_initiative_chs_chaos_lord_kho_07	Win a battle against any Daemon race.	false
initiatives_localised_description_wh3_dlc20_character_initiative_chs_chaos_lord_kho_08	Reach rank 15.	false
initiatives_localised_description_wh3_dlc20_character_initiative_chs_chaos_lord_kho_09	Use the Sacrifice Captives post-battle captive option.	false
initiatives_localised_description_wh3_dlc20_character_initiative_chs_chaos_lord_sla_01	Win 5 battles.	false
initiatives_localised_description_wh3_dlc20_character_initiative_chs_chaos_lord_sla_02	Win a battle with a unit of Fiends of Slaanesh in your army.	false
initiatives_localised_description_wh3_dlc20_character_initiative_chs_chaos_lord_sla_03	Win a battle with 2000 kills.	false
initiatives_localised_description_wh3_dlc20_character_initiative_chs_chaos_lord_sla_04	Rank-up in Raiding stance.	false
initiatives_localised_description_wh3_dlc20_character_initiative_chs_chaos_lord_sla_05	Win a battle against an army containing 5 missile units.	false
initiatives_localised_description_wh3_dlc20_character_initiative_chs_chaos_lord_sla_06	Lose a battle and survive.	false
initiatives_localised_description_wh3_dlc20_character_initiative_chs_chaos_lord_sla_07	Win a battle against any Daemon race.	false
initiatives_localised_description_wh3_dlc20_character_initiative_chs_chaos_lord_sla_08	Reach rank 15.	false
initiatives_localised_description_wh3_dlc20_character_initiative_chs_chaos_lord_sla_09	Use the Sacrifice Captives post-battle captive option.	false
initiatives_localised_description_wh3_dlc20_character_initiative_chs_chaos_lord_und_01	Win 5 battles.	false
initiatives_localised_description_wh3_dlc20_character_initiative_chs_chaos_lord_und_02	Win a battle with 2000 kills.	false
initiatives_localised_description_wh3_dlc20_character_initiative_chs_chaos_lord_und_03	Win a battle against an army with 3 characters.	false
initiatives_localised_description_wh3_dlc20_character_initiative_chs_chaos_lord_und_04	End your turn in a friendly region with less than -50 Control.	false
initiatives_localised_description_wh3_dlc20_character_initiative_chs_chaos_lord_und_05	Win a battle against an army containing 5 missile units.	false
initiatives_localised_description_wh3_dlc20_character_initiative_chs_chaos_lord_und_06	Lose a battle and survive.	false
initiatives_localised_description_wh3_dlc20_character_initiative_chs_chaos_lord_und_07	Win a battle against any Daemon race.	false
initiatives_localised_description_wh3_dlc20_character_initiative_chs_chaos_lord_und_08	Reach rank 15.	false
initiatives_localised_description_wh3_dlc20_character_initiative_chs_chaos_lord_und_09	Use the Sacrifice Captives post-battle captive option.	false
initiatives_localised_description_wh3_dlc20_character_initiative_chs_chaos_sorcerer_lord_nur_01	Win 5 battles.	false
initiatives_localised_description_wh3_dlc20_character_initiative_chs_chaos_sorcerer_lord_nur_02	Win a battle with another spellcaster in your army.	false
initiatives_localised_description_wh3_dlc20_character_initiative_chs_chaos_sorcerer_lord_nur_03	Win a battle with a unit of Aspiring Champions in your army.	false
initiatives_localised_description_wh3_dlc20_character_initiative_chs_chaos_sorcerer_lord_nur_04	Occupy a settlement with a Chaotic Wasteland climate.	false
initiatives_localised_description_wh3_dlc20_character_initiative_chs_chaos_sorcerer_lord_nur_05	Rank-up in Raiding stance.	false
initiatives_localised_description_wh3_dlc20_character_initiative_chs_chaos_sorcerer_lord_nur_06	Win a battle against Nurgle.	false
initiatives_localised_description_wh3_dlc20_character_initiative_chs_chaos_sorcerer_lord_nur_07	Rank-up in {{tr:channelling_stance}}.	false
initiatives_localised_description_wh3_dlc20_character_initiative_chs_chaos_sorcerer_lord_nur_08	Win a battle against any Daemon race.	false
initiatives_localised_description_wh3_dlc20_character_initiative_chs_chaos_sorcerer_lord_nur_09	Reach rank 15.	false
initiatives_localised_description_wh3_dlc20_character_initiative_chs_chaos_sorcerer_lord_nur_10	Use the Sacrifice Captives post-battle captive option.	false
initiatives_localised_description_wh3_dlc20_character_initiative_chs_chaos_sorcerer_lord_tze_01	Win 5 battles.	false
initiatives_localised_description_wh3_dlc20_character_initiative_chs_chaos_sorcerer_lord_tze_02	Win a battle with another spellcaster in your army.	false
initiatives_localised_description_wh3_dlc20_character_initiative_chs_chaos_sorcerer_lord_tze_03	Win a battle with a unit of Aspiring Champions in your army.	false
initiatives_localised_description_wh3_dlc20_character_initiative_chs_chaos_sorcerer_lord_tze_04	Win a battle against an army led by a spellcaster.	false
initiatives_localised_description_wh3_dlc20_character_initiative_chs_chaos_sorcerer_lord_tze_05	Rank-up in {{tr:channelling_stance}}.	false
initiatives_localised_description_wh3_dlc20_character_initiative_chs_chaos_sorcerer_lord_tze_06	Rank-up in {{tr:channelling_stance}}.	false
initiatives_localised_description_wh3_dlc20_character_initiative_chs_chaos_sorcerer_lord_tze_07	Win a battle against Tzeentch.	false
initiatives_localised_description_wh3_dlc20_character_initiative_chs_chaos_sorcerer_lord_tze_08	Win a battle against any Daemon race.	false
initiatives_localised_description_wh3_dlc20_character_initiative_chs_chaos_sorcerer_lord_tze_09	Reach rank 15.	false
initiatives_localised_description_wh3_dlc20_character_initiative_chs_chaos_sorcerer_lord_tze_10	Use the Sacrifice Captives post-battle captive option.	false
initiatives_localised_description_wh3_dlc20_character_initiative_chs_chaos_sorcerer_lord_und_01	Win 5 battles.	false
initiatives_localised_description_wh3_dlc20_character_initiative_chs_chaos_sorcerer_lord_und_02	Win a battle with another spellcaster in your army.	false
initiatives_localised_description_wh3_dlc20_character_initiative_chs_chaos_sorcerer_lord_und_03	Win a battle with a unit of Aspiring Champions in your army.	false
initiatives_localised_description_wh3_dlc20_character_initiative_chs_chaos_sorcerer_lord_und_04	Win a battle against Tzeentch.	false
initiatives_localised_description_wh3_dlc20_character_initiative_chs_chaos_sorcerer_lord_und_05	Win a battle against Nurgle.	false
initiatives_localised_description_wh3_dlc20_character_initiative_chs_chaos_sorcerer_lord_und_06	Rank-up in {{tr:channelling_stance}}.	false
initiatives_localised_description_wh3_dlc20_character_initiative_chs_chaos_sorcerer_lord_und_07	End your turn with over 80 Winds of Magic reserves.	false
initiatives_localised_description_wh3_dlc20_character_initiative_chs_chaos_sorcerer_lord_und_08	Win a battle against any Daemon race.	false
initiatives_localised_description_wh3_dlc20_character_initiative_chs_chaos_sorcerer_lord_und_09	Reach rank 15.	false
initiatives_localised_description_wh3_dlc20_character_initiative_chs_chaos_sorcerer_lord_und_10	Use the Sacrifice Captives post-battle captive option.	false
initiatives_localised_description_wh3_dlc20_character_initiative_chs_chaos_sorcerer_sla_01	Win 5 battles.	false
initiatives_localised_description_wh3_dlc20_character_initiative_chs_chaos_sorcerer_sla_02	Win a battle with another spellcaster in your army.	false
initiatives_localised_description_wh3_dlc20_character_initiative_chs_chaos_sorcerer_sla_03	Win a battle with 2 Hellstriders of Slaanesh units in your army.	false
initiatives_localised_description_wh3_dlc20_character_initiative_chs_chaos_sorcerer_sla_04	Win a battle against an army led by a spellcaster.	false
initiatives_localised_description_wh3_dlc20_character_initiative_chs_chaos_sorcerer_sla_05	Rank-up in Raiding stance.	false
initiatives_localised_description_wh3_dlc20_character_initiative_chs_chaos_sorcerer_sla_06	Win a battle with a unit of Fiends of Slaanesh in your army.	false
initiatives_localised_description_wh3_dlc20_character_initiative_chs_chaos_sorcerer_sla_07	Win a battle against Slaanesh.	false
initiatives_localised_description_wh3_dlc20_character_initiative_chs_chaos_sorcerer_sla_08	End your turn with over 80 Winds of Magic reserves.	false
initiatives_localised_description_wh3_dlc20_character_initiative_chs_chaos_sorcerer_sla_09	Successfully use a Hero action with this character.	false
initiatives_localised_description_wh3_dlc20_character_initiative_chs_chaos_sorcerer_sla_10	Win a battle against any Daemon race.	false
initiatives_localised_description_wh3_dlc20_character_initiative_chs_chaos_sorcerer_tze_01	Win 5 battles.	false
initiatives_localised_description_wh3_dlc20_character_initiative_chs_chaos_sorcerer_tze_02	Win a battle with another spellcaster in your army.	false
initiatives_localised_description_wh3_dlc20_character_initiative_chs_chaos_sorcerer_tze_03	End your turn with over 80 Winds of Magic reserves.	false
initiatives_localised_description_wh3_dlc20_character_initiative_chs_chaos_sorcerer_tze_04	Win a battle against an army led by a spellcaster.	false
initiatives_localised_description_wh3_dlc20_character_initiative_chs_chaos_sorcerer_tze_05	Rank-up in {{tr:channelling_stance}}.	false
initiatives_localised_description_wh3_dlc20_character_initiative_chs_chaos_sorcerer_tze_06	Win an ambush battle.	false
initiatives_localised_description_wh3_dlc20_character_initiative_chs_chaos_sorcerer_tze_07	Rank-up in {{tr:channelling_stance}}.	false
initiatives_localised_description_wh3_dlc20_character_initiative_chs_chaos_sorcerer_tze_08	Win a battle against Tzeentch.	false
initiatives_localised_description_wh3_dlc20_character_initiative_chs_chaos_sorcerer_tze_09	Successfully use a Hero action with this character.	false
initiatives_localised_description_wh3_dlc20_character_initiative_chs_chaos_sorcerer_tze_10	Win a battle against any Daemon race.	false
initiatives_localised_description_wh3_dlc20_character_initiative_chs_chaos_sorcerer_und_01	Win 5 battles.	false
initiatives_localised_description_wh3_dlc20_character_initiative_chs_chaos_sorcerer_und_02	Win a battle with another spellcaster in your army.	false
initiatives_localised_description_wh3_dlc20_character_initiative_chs_chaos_sorcerer_und_03	End your turn in a friendly region with less than -50 Control.	false
initiatives_localised_description_wh3_dlc20_character_initiative_chs_chaos_sorcerer_und_04	Win a battle against an army led by a spellcaster.	false
initiatives_localised_description_wh3_dlc20_character_initiative_chs_chaos_sorcerer_und_05	Win a battle against Slaanesh.	false
initiatives_localised_description_wh3_dlc20_character_initiative_chs_chaos_sorcerer_und_06	Win a battle against Tzeentch.	false
initiatives_localised_description_wh3_dlc20_character_initiative_chs_chaos_sorcerer_und_07	Rank-up in {{tr:channelling_stance}}.	false
initiatives_localised_description_wh3_dlc20_character_initiative_chs_chaos_sorcerer_und_08	End your turn with over 80 Winds of Magic reserves.	false
initiatives_localised_description_wh3_dlc20_character_initiative_chs_chaos_sorcerer_und_09	Successfully use a Hero action with this character.	false
initiatives_localised_description_wh3_dlc20_character_initiative_chs_chaos_sorcerer_und_10	Win a battle against any Daemon race.	false
initiatives_localised_description_wh3_dlc20_character_initiative_chs_daemon_prince_kho_01	Win 5 battles.	false
initiatives_localised_description_wh3_dlc20_character_initiative_chs_daemon_prince_kho_02	Win a battle against multiple armies.	false
initiatives_localised_description_wh3_dlc20_character_initiative_chs_daemon_prince_kho_03	Win a battle with 2000 kills.	false
initiatives_localised_description_wh3_dlc20_character_initiative_chs_daemon_prince_kho_04	Win a battle against any Daemon race.	false
initiatives_localised_description_wh3_dlc20_character_initiative_chs_daemon_prince_kho_05	Use the Kill Captives post-battle captive option.	false
initiatives_localised_description_wh3_dlc20_character_initiative_chs_daemon_prince_kho_06	Win a battle against an army containing 5 missile units.	false
initiatives_localised_description_wh3_dlc20_character_initiative_chs_daemon_prince_kho_07	Lose a battle and survive.	false
initiatives_localised_description_wh3_dlc20_character_initiative_chs_daemon_prince_kho_08	Reach rank 15.	false
initiatives_localised_description_wh3_dlc20_character_initiative_chs_daemon_prince_kho_09	Use the Sacrifice Captives post-battle captive option.	false
initiatives_localised_description_wh3_dlc20_character_initiative_chs_daemon_prince_nur_01	Win 5 battles.	false
initiatives_localised_description_wh3_dlc20_character_initiative_chs_daemon_prince_nur_02	Win a battle with another spellcaster in your army.	false
initiatives_localised_description_wh3_dlc20_character_initiative_chs_daemon_prince_nur_03	Win a battle with 2000 kills.	false
initiatives_localised_description_wh3_dlc20_character_initiative_chs_daemon_prince_nur_04	Win a battle against any Daemon race.	false
initiatives_localised_description_wh3_dlc20_character_initiative_chs_daemon_prince_nur_05	Use the Kill Captives post-battle captive option.	false
initiatives_localised_description_wh3_dlc20_character_initiative_chs_daemon_prince_nur_06	Win a battle against Nurgle.	false
initiatives_localised_description_wh3_dlc20_character_initiative_chs_daemon_prince_nur_07	Lose a battle and survive.	false
initiatives_localised_description_wh3_dlc20_character_initiative_chs_daemon_prince_nur_08	Reach rank 15.	false
initiatives_localised_description_wh3_dlc20_character_initiative_chs_daemon_prince_nur_09	Use the Sacrifice Captives post-battle captive option.	false
initiatives_localised_description_wh3_dlc20_character_initiative_chs_daemon_prince_sla_01	Win 5 battles.	false
initiatives_localised_description_wh3_dlc20_character_initiative_chs_daemon_prince_sla_02	Win a battle with another spellcaster in your army.	false
initiatives_localised_description_wh3_dlc20_character_initiative_chs_daemon_prince_sla_03	Win a battle with 2000 kills.	false
initiatives_localised_description_wh3_dlc20_character_initiative_chs_daemon_prince_sla_04	Win a battle against any Daemon race.	false
initiatives_localised_description_wh3_dlc20_character_initiative_chs_daemon_prince_sla_05	Use the Kill Captives post-battle captive option.	false
initiatives_localised_description_wh3_dlc20_character_initiative_chs_daemon_prince_sla_06	Win a battle against Slaanesh.	false
initiatives_localised_description_wh3_dlc20_character_initiative_chs_daemon_prince_sla_07	Lose a battle and survive.	false
initiatives_localised_description_wh3_dlc20_character_initiative_chs_daemon_prince_sla_08	Reach rank 15.	false
initiatives_localised_description_wh3_dlc20_character_initiative_chs_daemon_prince_sla_09	Use the Sacrifice Captives post-battle captive option.	false
initiatives_localised_description_wh3_dlc20_character_initiative_chs_daemon_prince_tze_01	Win 5 battles.	false
initiatives_localised_description_wh3_dlc20_character_initiative_chs_daemon_prince_tze_02	Win a battle with another spellcaster in your army.	false
initiatives_localised_description_wh3_dlc20_character_initiative_chs_daemon_prince_tze_03	End your turn with over 80 Winds of Magic reserves.	false
initiatives_localised_description_wh3_dlc20_character_initiative_chs_daemon_prince_tze_04	Win a battle against any Daemon race.	false
initiatives_localised_description_wh3_dlc20_character_initiative_chs_daemon_prince_tze_05	Use the Kill Captives post-battle captive option.	false
initiatives_localised_description_wh3_dlc20_character_initiative_chs_daemon_prince_tze_06	Win a battle against Tzeentch.	false
initiatives_localised_description_wh3_dlc20_character_initiative_chs_daemon_prince_tze_07	Lose a battle and survive.	false
initiatives_localised_description_wh3_dlc20_character_initiative_chs_daemon_prince_tze_08	Reach rank 15.	false
initiatives_localised_description_wh3_dlc20_character_initiative_chs_daemon_prince_tze_09	Use the Sacrifice Captives post-battle captive option.	false
initiatives_localised_description_wh3_dlc20_character_initiative_chs_daemon_prince_und_01	Win 5 battles.	false
initiatives_localised_description_wh3_dlc20_character_initiative_chs_daemon_prince_und_02	Win a battle with another spellcaster in your army.	false
initiatives_localised_description_wh3_dlc20_character_initiative_chs_daemon_prince_und_03	Win a battle with 2000 kills.	false
initiatives_localised_description_wh3_dlc20_character_initiative_chs_daemon_prince_und_04	Win a battle against any Daemon race.	false
initiatives_localised_description_wh3_dlc20_character_initiative_chs_daemon_prince_und_05	Use the Kill Captives post-battle captive option.	false
initiatives_localised_description_wh3_dlc20_character_initiative_chs_daemon_prince_und_06	Win a battle against an army led by a spellcaster.	false
initiatives_localised_description_wh3_dlc20_character_initiative_chs_daemon_prince_und_07	Lose a battle and survive.	false
initiatives_localised_description_wh3_dlc20_character_initiative_chs_daemon_prince_und_08	Reach rank 15.	false
initiatives_localised_description_wh3_dlc20_character_initiative_chs_daemon_prince_und_09	Use the Sacrifice Captives post-battle captive option.	false
initiatives_localised_description_wh3_dlc20_character_initiative_chs_exalted_hero_kho_01	Win 5 battles.	false
initiatives_localised_description_wh3_dlc20_character_initiative_chs_exalted_hero_kho_02	Win a battle with 2 Chaos Knights units in your army.	false
initiatives_localised_description_wh3_dlc20_character_initiative_chs_exalted_hero_kho_03	Win a battle with a unit of Skullcrushers in your army.	false
initiatives_localised_description_wh3_dlc20_character_initiative_chs_exalted_hero_kho_04	Win a battle against multiple armies.	false
initiatives_localised_description_wh3_dlc20_character_initiative_chs_exalted_hero_kho_05	Win a battle with 2000 kills.	false
initiatives_localised_description_wh3_dlc20_character_initiative_chs_exalted_hero_kho_06	Win a battle against an army led by a spellcaster.	false
initiatives_localised_description_wh3_dlc20_character_initiative_chs_exalted_hero_kho_07	Lose a battle and survive.	false
initiatives_localised_description_wh3_dlc20_character_initiative_chs_exalted_hero_kho_08	Win a battle with 3 Chosen units in your army.	false
initiatives_localised_description_wh3_dlc20_character_initiative_chs_exalted_hero_kho_09	Win a battle against any Daemon race.	false
initiatives_localised_description_wh3_dlc20_character_initiative_chs_exalted_hero_kho_10	Successfully use a Hero action with this character.	false
initiatives_localised_description_wh3_dlc20_character_initiative_chs_exalted_hero_nur_01	Win 5 battles.	false
initiatives_localised_description_wh3_dlc20_character_initiative_chs_exalted_hero_nur_02	Win a battle with 2 Chaos Knights units in your army.	false
initiatives_localised_description_wh3_dlc20_character_initiative_chs_exalted_hero_nur_03	Win a battle with 2000 kills.	false
initiatives_localised_description_wh3_dlc20_character_initiative_chs_exalted_hero_nur_04	Win a battle against an army led by a spellcaster.	false
initiatives_localised_description_wh3_dlc20_character_initiative_chs_exalted_hero_nur_05	Rank-up in Raiding stance.	false
initiatives_localised_description_wh3_dlc20_character_initiative_chs_exalted_hero_nur_06	Occupy a settlement with a Chaotic Wasteland climate.	false
initiatives_localised_description_wh3_dlc20_character_initiative_chs_exalted_hero_nur_07	Lose a battle and survive.	false
initiatives_localised_description_wh3_dlc20_character_initiative_chs_exalted_hero_nur_08	Win a battle with 3 Chosen units in your army.	false
initiatives_localised_description_wh3_dlc20_character_initiative_chs_exalted_hero_nur_09	Win a battle against any Daemon race.	false
initiatives_localised_description_wh3_dlc20_character_initiative_chs_exalted_hero_nur_10	Successfully use a Hero action with this character.	false
initiatives_localised_description_wh3_dlc20_character_initiative_chs_exalted_hero_und_01	Win 5 battles.	false
initiatives_localised_description_wh3_dlc20_character_initiative_chs_exalted_hero_und_02	Win a battle with 2 Chaos Knights units in your army.	false
initiatives_localised_description_wh3_dlc20_character_initiative_chs_exalted_hero_und_03	Win a battle with 2000 kills.	false
initiatives_localised_description_wh3_dlc20_character_initiative_chs_exalted_hero_und_04	Win a battle against an army led by a spellcaster.	false
initiatives_localised_description_wh3_dlc20_character_initiative_chs_exalted_hero_und_05	End your turn in a friendly region with less than -50 Control.	false
initiatives_localised_description_wh3_dlc20_character_initiative_chs_exalted_hero_und_06	Lose a battle and survive.	false
initiatives_localised_description_wh3_dlc20_character_initiative_chs_exalted_hero_und_07	Win a battle with 3 Chosen units in your army.	false
initiatives_localised_description_wh3_dlc20_character_initiative_chs_exalted_hero_und_08	Win a battle against any Daemon race.	false
initiatives_localised_description_wh3_dlc20_character_initiative_chs_exalted_hero_und_09	Successfully use a Hero action with this character.	false
initiatives_localised_description_wh3_dlc20_character_initiative_devote_exalted_hero_to_khorne	Character must reach rank 5.	false
initiatives_localised_description_wh3_dlc20_character_initiative_devote_exalted_hero_to_nurgle	Character must reach rank 5.	false
initiatives_localised_description_wh3_dlc20_character_initiative_devote_lord_to_khorne	Character must reach rank 5.	false
initiatives_localised_description_wh3_dlc20_character_initiative_devote_lord_to_nurgle	Character must reach rank 5.	false
initiatives_localised_description_wh3_dlc20_character_initiative_devote_lord_to_slaanesh	Character must reach rank 5.	false
initiatives_localised_description_wh3_dlc20_character_initiative_devote_sorceror_lord_to_nurgle_death	Character must reach rank 5.	false
initiatives_localised_description_wh3_dlc20_character_initiative_devote_sorceror_lord_to_nurgle_nurgle	Character must reach rank 5.	false
initiatives_localised_description_wh3_dlc20_character_initiative_devote_sorceror_lord_to_tzeentch_metal	Character must reach rank 5.	false
initiatives_localised_description_wh3_dlc20_character_initiative_devote_sorceror_lord_to_tzeentch_tzeentch	Character must reach rank 5.	false
initiatives_localised_description_wh3_dlc20_character_initiative_devote_sorceror_to_slaanesh_shadows	Character must reach rank 5.	false
initiatives_localised_description_wh3_dlc20_character_initiative_devote_sorceror_to_slaanesh_slaanesh	Character must reach rank 5.	false
initiatives_localised_description_wh3_dlc20_character_initiative_devote_sorceror_to_tzeentch_metal	Character must reach rank 5.	false
initiatives_localised_description_wh3_dlc20_character_initiative_devote_sorceror_to_tzeentch_tzeentch	Character must reach rank 5.	false
initiatives_localised_description_wh3_dlc20_faction_initiative_chs_khorne_1_army_xp	placeholder	false
initiatives_localised_description_wh3_dlc20_faction_initiative_chs_khorne_1_economy_post_battle_income	placeholder	false
initiatives_localised_description_wh3_dlc20_faction_initiative_chs_khorne_1_units_bloodletters	placeholder	false
initiatives_localised_description_wh3_dlc20_faction_initiative_chs_khorne_1_units_flesh_hounds	placeholder	false
initiatives_localised_description_wh3_dlc20_faction_initiative_chs_khorne_2_army_upgrades	placeholder	false
initiatives_localised_description_wh3_dlc20_faction_initiative_chs_khorne_3_characters_marking	placeholder	false
initiatives_localised_description_wh3_dlc20_faction_initiative_chs_khorne_3_units_skullcannons	placeholder	false
initiatives_localised_description_wh3_dlc20_faction_initiative_chs_khorne_3_units_warshrine	placeholder	false
initiatives_localised_description_wh3_dlc20_faction_initiative_chs_khorne_5_units_bloodthirsters	placeholder	false
initiatives_localised_description_wh3_dlc20_faction_initiative_chs_khorne_5_units_soul_grinder	placeholder	false
initiatives_localised_description_wh3_dlc20_faction_initiative_chs_nurgle_1_army_replenishment	placeholder	false
initiatives_localised_description_wh3_dlc20_faction_initiative_chs_nurgle_1_economy_growth	placeholder	false
initiatives_localised_description_wh3_dlc20_faction_initiative_chs_nurgle_1_units_beast_of_nurgle	placeholder	false
initiatives_localised_description_wh3_dlc20_faction_initiative_chs_nurgle_1_units_plaguebearers	placeholder	false
initiatives_localised_description_wh3_dlc20_faction_initiative_chs_nurgle_2_army_upgrades	placeholder	false
initiatives_localised_description_wh3_dlc20_faction_initiative_chs_nurgle_3_characters_marking	placeholder	false
initiatives_localised_description_wh3_dlc20_faction_initiative_chs_nurgle_3_units_plague_drones	placeholder	false
initiatives_localised_description_wh3_dlc20_faction_initiative_chs_nurgle_3_units_warshrine		false
initiatives_localised_description_wh3_dlc20_faction_initiative_chs_nurgle_5_units_great_unclean_one	placeholder	false
initiatives_localised_description_wh3_dlc20_faction_initiative_chs_nurgle_5_units_soul_grinder	placeholder	false
initiatives_localised_description_wh3_dlc20_faction_initiative_chs_slaanesh_1_army_movement	placeholder	false
initiatives_localised_description_wh3_dlc20_faction_initiative_chs_slaanesh_1_economy_control	placeholder	false
initiatives_localised_description_wh3_dlc20_faction_initiative_chs_slaanesh_1_units_daemonettes	placeholder	false
initiatives_localised_description_wh3_dlc20_faction_initiative_chs_slaanesh_1_units_seeker_chariots	placeholder	false
initiatives_localised_description_wh3_dlc20_faction_initiative_chs_slaanesh_2_army_upgrades	placeholder	false
initiatives_localised_description_wh3_dlc20_faction_initiative_chs_slaanesh_3_characters_marking	placeholder	false
initiatives_localised_description_wh3_dlc20_faction_initiative_chs_slaanesh_3_units_fiends	placeholder	false
initiatives_localised_description_wh3_dlc20_faction_initiative_chs_slaanesh_3_units_warshrine	placeholder	false
initiatives_localised_description_wh3_dlc20_faction_initiative_chs_slaanesh_5_units_keeper_of_secrets	placeholder	false
initiatives_localised_description_wh3_dlc20_faction_initiative_chs_slaanesh_5_units_soul_grinder	placeholder	false
initiatives_localised_description_wh3_dlc20_faction_initiative_chs_tzeentch_1_army_winds	placeholder	false
initiatives_localised_description_wh3_dlc20_faction_initiative_chs_tzeentch_1_economy_technology	placeholder	false
initiatives_localised_description_wh3_dlc20_faction_initiative_chs_tzeentch_1_units_pink_horrors	placeholder	false
initiatives_localised_description_wh3_dlc20_faction_initiative_chs_tzeentch_1_units_screamers	placeholder	false
initiatives_localised_description_wh3_dlc20_faction_initiative_chs_tzeentch_2_army_upgrades	placeholder	false
initiatives_localised_description_wh3_dlc20_faction_initiative_chs_tzeentch_3_characters_marking	placeholder	false
initiatives_localised_description_wh3_dlc20_faction_initiative_chs_tzeentch_3_units_flamers	placeholder	false
initiatives_localised_description_wh3_dlc20_faction_initiative_chs_tzeentch_3_units_warshrine	placeholder	false
initiatives_localised_description_wh3_dlc20_faction_initiative_chs_tzeentch_5_units_lord_of_Change	placeholder	false
initiatives_localised_description_wh3_dlc20_faction_initiative_chs_tzeentch_5_units_soul_grinder	placeholder	false
initiatives_localised_description_wh3_dlc20_faction_initiative_chs_undivided_1_army_marauders	placeholder	false
initiatives_localised_description_wh3_dlc20_faction_initiative_chs_undivided_1_economy_building	placeholder	false
initiatives_localised_description_wh3_dlc20_faction_initiative_chs_undivided_1_units_furies	placeholder	false
initiatives_localised_description_wh3_dlc20_faction_initiative_chs_undivided_2_army_upgrades	placeholder	false
initiatives_localised_description_wh3_dlc20_faction_initiative_chs_undivided_2_economy_vassals	placeholder	false
initiatives_localised_description_wh3_dlc20_faction_initiative_chs_undivided_2_xp_sharing	does a thing?	false
initiatives_localised_description_wh3_dlc20_faction_initiative_chs_undivided_3_army_elites	placeholder	false
initiatives_localised_description_wh3_dlc20_faction_initiative_chs_undivided_3_characters_marking	placeholder	false
initiatives_localised_description_wh3_dlc20_faction_initiative_chs_undivided_3_units_hellcannons	placeholder	false
initiatives_localised_description_wh3_dlc20_faction_initiative_chs_undivided_3_units_warshrine	placeholder	false
initiatives_localised_description_wh3_dlc20_faction_initiative_chs_undivided_5_units_shaggoths	placeholder	false
initiatives_localised_description_wh3_dlc23_faction_initiative_chd_category_bull_centaurs_1		false
initiatives_localised_description_wh3_dlc23_faction_initiative_chd_category_bull_centaurs_2		false
initiatives_localised_description_wh3_dlc23_faction_initiative_chd_category_bull_centaurs_3		false
initiatives_localised_description_wh3_dlc23_faction_initiative_chd_category_bull_centaurs_4		false
initiatives_localised_description_wh3_dlc23_faction_initiative_chd_category_bull_centaurs_5		false
initiatives_localised_description_wh3_dlc23_faction_initiative_chd_category_bull_centaurs_6		false
initiatives_localised_description_wh3_dlc23_faction_initiative_chd_category_bull_centaurs_7		false
initiatives_localised_description_wh3_dlc23_faction_initiative_chd_category_bull_centaurs_8		false
initiatives_localised_description_wh3_dlc23_faction_initiative_chd_category_flying_beasts_1		false
initiatives_localised_description_wh3_dlc23_faction_initiative_chd_category_flying_beasts_2		false
initiatives_localised_description_wh3_dlc23_faction_initiative_chd_category_flying_beasts_3	placeholder	false
initiatives_localised_description_wh3_dlc23_faction_initiative_chd_category_flying_beasts_4	placeholder	false
initiatives_localised_description_wh3_dlc23_faction_initiative_chd_category_flying_beasts_5	placeholder	false
initiatives_localised_description_wh3_dlc23_faction_initiative_chd_category_flying_beasts_6	placeholder	false
initiatives_localised_description_wh3_dlc23_faction_initiative_chd_category_flying_beasts_7	placeholder	false
initiatives_localised_description_wh3_dlc23_faction_initiative_chd_category_flying_beasts_8	placeholder	false
initiatives_localised_description_wh3_dlc23_faction_initiative_chd_category_kdaai_1		false
initiatives_localised_description_wh3_dlc23_faction_initiative_chd_category_kdaai_2		false
initiatives_localised_description_wh3_dlc23_faction_initiative_chd_category_kdaai_3		false
initiatives_localised_description_wh3_dlc23_faction_initiative_chd_category_kdaai_4		false
initiatives_localised_description_wh3_dlc23_faction_initiative_chd_category_kdaai_5		false
initiatives_localised_description_wh3_dlc23_faction_initiative_chd_category_kdaai_6		false
initiatives_localised_description_wh3_dlc23_faction_initiative_chd_category_kdaai_7		false
initiatives_localised_description_wh3_dlc23_faction_initiative_chd_category_kdaai_8		false
initiatives_localised_description_wh3_dlc23_faction_initiative_chd_category_melee_infantry_1		false
initiatives_localised_description_wh3_dlc23_faction_initiative_chd_category_melee_infantry_2		false
initiatives_localised_description_wh3_dlc23_faction_initiative_chd_category_melee_infantry_3		false
initiatives_localised_description_wh3_dlc23_faction_initiative_chd_category_melee_infantry_4		false
initiatives_localised_description_wh3_dlc23_faction_initiative_chd_category_melee_infantry_5		false
initiatives_localised_description_wh3_dlc23_faction_initiative_chd_category_melee_infantry_6		false
initiatives_localised_description_wh3_dlc23_faction_initiative_chd_category_melee_infantry_7		false
initiatives_localised_description_wh3_dlc23_faction_initiative_chd_category_melee_infantry_8		false
initiatives_localised_description_wh3_dlc23_faction_initiative_chd_category_missile_infantry_1		false
initiatives_localised_description_wh3_dlc23_faction_initiative_chd_category_missile_infantry_2		false
initiatives_localised_description_wh3_dlc23_faction_initiative_chd_category_missile_infantry_3		false
initiatives_localised_description_wh3_dlc23_faction_initiative_chd_category_missile_infantry_4		false
initiatives_localised_description_wh3_dlc23_faction_initiative_chd_category_missile_infantry_5		false
initiatives_localised_description_wh3_dlc23_faction_initiative_chd_category_missile_infantry_6		false
initiatives_localised_description_wh3_dlc23_faction_initiative_chd_category_missile_infantry_7		false
initiatives_localised_description_wh3_dlc23_faction_initiative_chd_category_missile_infantry_8		false
initiatives_localised_description_wh3_dlc23_faction_initiative_chd_category_warmachines_1		false
initiatives_localised_description_wh3_dlc23_faction_initiative_chd_category_warmachines_2		false
initiatives_localised_description_wh3_dlc23_faction_initiative_chd_category_warmachines_3		false
initiatives_localised_description_wh3_dlc23_faction_initiative_chd_category_warmachines_4		false
initiatives_localised_description_wh3_dlc23_faction_initiative_chd_category_warmachines_5		false
initiatives_localised_description_wh3_dlc23_faction_initiative_chd_category_warmachines_6		false
initiatives_localised_description_wh3_dlc23_faction_initiative_chd_category_warmachines_7		false
initiatives_localised_description_wh3_dlc23_faction_initiative_chd_category_warmachines_8		false
initiatives_localised_description_wh3_dlc23_faction_initiative_chd_category_warmachines_carriage_dummy_1		false
initiatives_localised_description_wh3_dlc23_faction_initiative_chd_category_warmachines_carriage_dummy_2		false
initiatives_localised_description_wh3_dlc24_character_initiative_chs_chaos_lord_tze_01	{{tr:initiatives_localised_description_wh3_dlc20_character_initiative_chs_chaos_lord_kho_01}}	false
initiatives_localised_description_wh3_dlc24_character_initiative_chs_chaos_lord_tze_02	{{tr:initiatives_localised_description_wh3_dlc20_character_initiative_chs_chaos_sorcerer_lord_tze_05}}	false
initiatives_localised_description_wh3_dlc24_character_initiative_chs_chaos_lord_tze_03	{{tr:initiatives_localised_description_wh3_dlc20_character_initiative_chs_chaos_lord_kho_03}}	false
initiatives_localised_description_wh3_dlc24_character_initiative_chs_chaos_lord_tze_04	{{tr:initiatives_localised_description_wh3_dlc20_character_initiative_chs_chaos_sorcerer_lord_tze_06}}	false
initiatives_localised_description_wh3_dlc24_character_initiative_chs_chaos_lord_tze_05	{{tr:initiatives_localised_description_wh3_dlc20_character_initiative_chs_chaos_lord_kho_05}}	false
initiatives_localised_description_wh3_dlc24_character_initiative_chs_chaos_lord_tze_06	{{tr:initiatives_localised_description_wh3_dlc20_character_initiative_chs_chaos_lord_kho_06}}	false
initiatives_localised_description_wh3_dlc24_character_initiative_chs_chaos_lord_tze_07	{{tr:initiatives_localised_description_wh3_dlc20_character_initiative_chs_chaos_lord_kho_07}}	false
initiatives_localised_description_wh3_dlc24_character_initiative_chs_chaos_lord_tze_08	{{tr:initiatives_localised_description_wh3_dlc20_character_initiative_chs_chaos_lord_kho_08}}	false
initiatives_localised_description_wh3_dlc24_character_initiative_chs_chaos_lord_tze_09	{{tr:initiatives_localised_description_wh3_dlc20_character_initiative_chs_chaos_lord_kho_09}}	false
initiatives_localised_description_wh3_dlc24_character_initiative_chs_exalted_hero_tze_01	{{tr:initiatives_localised_description_wh3_dlc20_character_initiative_chs_exalted_hero_kho_01}}	false
initiatives_localised_description_wh3_dlc24_character_initiative_chs_exalted_hero_tze_02	{{tr:initiatives_localised_description_wh3_dlc20_character_initiative_chs_exalted_hero_kho_02}}	false
initiatives_localised_description_wh3_dlc24_character_initiative_chs_exalted_hero_tze_03	{{tr:initiatives_localised_description_wh3_dlc20_character_initiative_chs_chaos_sorcerer_lord_tze_05}}	false
initiatives_localised_description_wh3_dlc24_character_initiative_chs_exalted_hero_tze_04	{{tr:initiatives_localised_description_wh3_dlc20_character_initiative_chs_chaos_sorcerer_lord_tze_06}}	false
initiatives_localised_description_wh3_dlc24_character_initiative_chs_exalted_hero_tze_05	{{tr:initiatives_localised_description_wh3_dlc20_character_initiative_chs_exalted_hero_kho_05}}	false
initiatives_localised_description_wh3_dlc24_character_initiative_chs_exalted_hero_tze_06	{{tr:initiatives_localised_description_wh3_dlc20_character_initiative_chs_exalted_hero_kho_06}}	false
initiatives_localised_description_wh3_dlc24_character_initiative_chs_exalted_hero_tze_07	{{tr:initiatives_localised_description_wh3_dlc20_character_initiative_chs_exalted_hero_kho_07}}	false
initiatives_localised_description_wh3_dlc24_character_initiative_chs_exalted_hero_tze_08	{{tr:initiatives_localised_description_wh3_dlc20_character_initiative_chs_exalted_hero_kho_08}}	false
initiatives_localised_description_wh3_dlc24_character_initiative_chs_exalted_hero_tze_09	{{tr:initiatives_localised_description_wh3_dlc20_character_initiative_chs_exalted_hero_kho_09}}	false
initiatives_localised_description_wh3_dlc24_character_initiative_chs_exalted_hero_tze_10	{{tr:initiatives_localised_description_wh3_dlc20_character_initiative_chs_exalted_hero_kho_10}}	false
initiatives_localised_description_wh3_dlc24_character_initiative_devote_exalted_hero_to_tzeentch	{{tr:initiatives_localised_description_wh3_dlc20_character_initiative_devote_exalted_hero_to_nurgle}}	false
initiatives_localised_description_wh3_dlc24_character_initiative_devote_lord_to_tzeentch	{{tr:initiatives_localised_description_wh3_dlc20_character_initiative_devote_exalted_hero_to_nurgle}}	false
initiatives_localised_description_wh3_dlc24_faction_initiative_chs_tzeentch_3_units_changebringers	placeholder	false
initiatives_localised_description_wh3_dlc24_faction_initiative_chs_tzeentch_3_units_cockatrice	placeholder	false
initiatives_localised_description_wh3_dlc24_faction_initiative_chs_tzeentch_3_units_mutalith_vortex_beast	placeholder	false
initiatives_localised_description_wh3_dlc25_character_initiative_chs_chaos_lord_nur_01	Win 5 battles.	false
initiatives_localised_description_wh3_dlc25_character_initiative_chs_chaos_lord_nur_02	Rank-up in Raiding stance.	false
initiatives_localised_description_wh3_dlc25_character_initiative_chs_chaos_lord_nur_03	Win a battle with 2000 kills.	false
initiatives_localised_description_wh3_dlc25_character_initiative_chs_chaos_lord_nur_04	Occupy a settlement with a Chaotic Wasteland climate.	false
initiatives_localised_description_wh3_dlc25_character_initiative_chs_chaos_lord_nur_05	Win a battle against an army containing 5 missile units.	false
initiatives_localised_description_wh3_dlc25_character_initiative_chs_chaos_lord_nur_06	Lose a battle and survive.	false
initiatives_localised_description_wh3_dlc25_character_initiative_chs_chaos_lord_nur_07	Win a battle against any Daemon race.	false
initiatives_localised_description_wh3_dlc25_character_initiative_chs_chaos_lord_nur_08	Reach rank 15.	false
initiatives_localised_description_wh3_dlc25_character_initiative_chs_chaos_lord_nur_09	Use the Sacrifice Captives post-battle captive option.	false
initiatives_localised_description_wh3_dlc25_character_initiative_chs_chaos_sorcerer_nur_01	Win 5 battles.	false
initiatives_localised_description_wh3_dlc25_character_initiative_chs_chaos_sorcerer_nur_02	Win a battle with another spellcaster in your army.	false
initiatives_localised_description_wh3_dlc25_character_initiative_chs_chaos_sorcerer_nur_03	Win a battle against an army led by a spellcaster.	false
initiatives_localised_description_wh3_dlc25_character_initiative_chs_chaos_sorcerer_nur_04	Occupy a settlement with a Chaotic Wasteland climate.	false
initiatives_localised_description_wh3_dlc25_character_initiative_chs_chaos_sorcerer_nur_05	Win a battle against Nurgle.	false
initiatives_localised_description_wh3_dlc25_character_initiative_chs_chaos_sorcerer_nur_06	Rank-up in Raiding stance.	false
initiatives_localised_description_wh3_dlc25_character_initiative_chs_chaos_sorcerer_nur_07	End your turn with over 80 Winds of Magic reserves.	false
initiatives_localised_description_wh3_dlc25_character_initiative_chs_chaos_sorcerer_nur_08	Successfully use a Hero action with this character.	false
initiatives_localised_description_wh3_dlc25_character_initiative_chs_chaos_sorcerer_nur_09	Win a battle against any Daemon race.	false
initiatives_localised_description_wh3_dlc25_character_initiative_devote_sorceror_to_nurgle_death	Character must reach rank 5.	false
initiatives_localised_description_wh3_dlc25_character_initiative_devote_sorceror_to_nurgle_nurgle	Character must reach rank 5.	false
initiatives_localised_description_wh3_dlc25_faction_initiative_chs_nurgle_3_units_plague_ogres	placeholder	false
initiatives_localised_description_wh3_dlc25_faction_initiative_chs_nurgle_5_units_toad_dragon	placeholder	false
initiatives_localised_description_wh3_main_character_initiative_ogr_big_name_arsebelcher	It is a mystery!	false
initiatives_localised_description_wh3_main_character_initiative_ogr_big_name_beastkiller	Win a battle against Beastmen.	false
initiatives_localised_description_wh3_main_character_initiative_ogr_big_name_beastrider	Unlock the Stonehorn mount.	false
initiatives_localised_description_wh3_main_character_initiative_ogr_big_name_bellyslapper	Use the Eat Captives post-battle captive option.	false
initiatives_localised_description_wh3_main_character_initiative_ogr_big_name_bigbellower	Win a battle whilst being reinforced.	false
initiatives_localised_description_wh3_main_character_initiative_ogr_big_name_bonechewer	End your turn with over 50 meat.	false
initiatives_localised_description_wh3_main_character_initiative_ogr_big_name_boommaker	Win a battle with a unit of Leadbelchers in your army.	false
initiatives_localised_description_wh3_main_character_initiative_ogr_big_name_brawlerguts	Win 5 battles.	false
initiatives_localised_description_wh3_main_character_initiative_ogr_big_name_campmaker	Deploy a camp from this character.	false
initiatives_localised_description_wh3_main_character_initiative_ogr_big_name_chaos_slayer	Capture The Challenge Stone settlement.	false
initiatives_localised_description_wh3_main_character_initiative_ogr_big_name_daemonbreaker	Win a battle against any Daemon race.	false
initiatives_localised_description_wh3_main_character_initiative_ogr_big_name_deathcheater	Lose a battle and survive.	false
initiatives_localised_description_wh3_main_character_initiative_ogr_big_name_dwarfsquasher	Win a battle against Dwarfs.	false
initiatives_localised_description_wh3_main_character_initiative_ogr_big_name_elfmulcher	Win a battle against Wood Elves, High Elves or Dark Elves.	false
initiatives_localised_description_wh3_main_character_initiative_ogr_big_name_giantbreaker	Win a battle against an army containing a Giant unit.	false
initiatives_localised_description_wh3_main_character_initiative_ogr_big_name_gnoblarkicker	Win a battle with 5 Gnoblar units in your army.	false
initiatives_localised_description_wh3_main_character_initiative_ogr_big_name_goldhoarder	Sack a settlement with this character.	false
initiatives_localised_description_wh3_main_character_initiative_ogr_big_name_grandfeaster	Reach rank 40.	false
initiatives_localised_description_wh3_main_character_initiative_ogr_big_name_greasus_gatecrasher	Win a siege battle.	false
initiatives_localised_description_wh3_main_character_initiative_ogr_big_name_greasus_hoardmaster	Win a battle against Ogre Kingdoms.	false
initiatives_localised_description_wh3_main_character_initiative_ogr_big_name_greasus_shockingly_obese	Use the Process Meat post-battle captive option.	false
initiatives_localised_description_wh3_main_character_initiative_ogr_big_name_greasus_tradelord	Rank-up in Raiding stance.	false
initiatives_localised_description_wh3_main_character_initiative_ogr_big_name_groundbreaker	Win a battle against Cathay.	false
initiatives_localised_description_wh3_main_character_initiative_ogr_big_name_gutcrusher	Win a battle with 2500 kills.	false
initiatives_localised_description_wh3_main_character_initiative_ogr_big_name_kineater	Lose a battle with more kills than your opponent.	false
initiatives_localised_description_wh3_main_character_initiative_ogr_big_name_lizardstrangler	Win a battle against Lizardmen.	false
initiatives_localised_description_wh3_main_character_initiative_ogr_big_name_longstrider	Reach rank 10.	false
initiatives_localised_description_wh3_main_character_initiative_ogr_big_name_magichunter	Win a battle against an army led by a spellcaster.	false
initiatives_localised_description_wh3_main_character_initiative_ogr_big_name_maneater	Win a battle against The Empire or Bretonnia.	false
initiatives_localised_description_wh3_main_character_initiative_ogr_big_name_mawseeker	Capture the Xen Wu settlement.	false
initiatives_localised_description_wh3_main_character_initiative_ogr_big_name_mountaineater	Occupy a settlement with a mountain climate.	false
initiatives_localised_description_wh3_main_character_initiative_ogr_big_name_mountaintalker	Win a battle in a mountain climate.	false
initiatives_localised_description_wh3_main_character_initiative_ogr_big_name_ogrekiller	Win a battle against Ogre Kingdoms.	false
initiatives_localised_description_wh3_main_character_initiative_ogr_big_name_orcsplitter	Win a battle against Greenskins.	false
initiatives_localised_description_wh3_main_character_initiative_ogr_big_name_ratkiller	Win a battle against Skaven.	false
initiatives_localised_description_wh3_main_character_initiative_ogr_big_name_skrag_ever_famished	End your turn with over 50 meat.	false
initiatives_localised_description_wh3_main_character_initiative_ogr_big_name_skrag_gore_harvester	Use the Process Meat post-battle captive option.	false
initiatives_localised_description_wh3_main_character_initiative_ogr_big_name_skrag_maw_that_walks	Win a battle against an army led by a spellcaster.	false
initiatives_localised_description_wh3_main_character_initiative_ogr_big_name_skrag_world_swallower	Win 5 battles.	false
initiatives_localised_description_wh3_main_character_initiative_ogr_big_name_staydeader	Win a battle against Vampire Counts, Vampire Coast or Tomb Kings.	false
initiatives_localised_description_wh3_main_character_initiative_ogr_big_name_wallcrusher	Win a siege battle.	false
initiatives_localised_description_wh3_pro11_character_initiative_chs_harald_hammerstorm_01	Kill Karl Franz	false
initiatives_localised_description_wh3_pro11_character_initiative_chs_harald_hammerstorm_02	Kill a Legendary Undead character	false
initiatives_localised_description_wh3_pro11_character_initiative_chs_harald_hammerstorm_03	Kill a greater daemon lord	false
initiatives_localised_name_wh3_dlc20_character_initiative_ascend_lord_to_daemon_prince_khorne	Ascend to Daemonhood (Khorne)	false
initiatives_localised_name_wh3_dlc20_character_initiative_ascend_lord_to_daemon_prince_khorne_from_und	Ascend to Daemonhood (Khorne)	false
initiatives_localised_name_wh3_dlc20_character_initiative_ascend_lord_to_daemon_prince_nurgle	Ascend to Daemonhood (Nurgle)	false
initiatives_localised_name_wh3_dlc20_character_initiative_ascend_lord_to_daemon_prince_nurgle_from_und	Ascend to Daemonhood (Nurgle)	false
initiatives_localised_name_wh3_dlc20_character_initiative_ascend_lord_to_daemon_prince_slaanesh	Ascend to Daemonhood (Slaanesh)	false
initiatives_localised_name_wh3_dlc20_character_initiative_ascend_lord_to_daemon_prince_slaanesh_from_und	Ascend to Daemonhood (Slaanesh)	false
initiatives_localised_name_wh3_dlc20_character_initiative_ascend_lord_to_daemon_prince_tzeentch	Ascend to Daemonhood (Tzeentch)	false
initiatives_localised_name_wh3_dlc20_character_initiative_ascend_lord_to_daemon_prince_tzeentch_from_und	Ascend to Daemonhood (Tzeentch)	false
initiatives_localised_name_wh3_dlc20_character_initiative_ascend_lord_to_daemon_prince_undivided	Ascend to Daemonhood (Undivided)	false
initiatives_localised_name_wh3_dlc20_character_initiative_chs_chaos_lord_kho_01	Unbreakable	false
initiatives_localised_name_wh3_dlc20_character_initiative_chs_chaos_lord_kho_02	Slaughterlord	false
initiatives_localised_name_wh3_dlc20_character_initiative_chs_chaos_lord_kho_03	Master of Massacre	false
initiatives_localised_name_wh3_dlc20_character_initiative_chs_chaos_lord_kho_04	Slayer of Champions	false
initiatives_localised_name_wh3_dlc20_character_initiative_chs_chaos_lord_kho_05	Impenetrable	false
initiatives_localised_name_wh3_dlc20_character_initiative_chs_chaos_lord_kho_06	Survivor	false
initiatives_localised_name_wh3_dlc20_character_initiative_chs_chaos_lord_kho_07	Mortal Supremacy	false
initiatives_localised_name_wh3_dlc20_character_initiative_chs_chaos_lord_kho_08	Indisputable Champion	false
initiatives_localised_name_wh3_dlc20_character_initiative_chs_chaos_lord_kho_09	Soul Harvester	false
initiatives_localised_name_wh3_dlc20_character_initiative_chs_chaos_lord_sla_01	Unbreakable	false
initiatives_localised_name_wh3_dlc20_character_initiative_chs_chaos_lord_sla_02	Fiend Leader	false
initiatives_localised_name_wh3_dlc20_character_initiative_chs_chaos_lord_sla_03	Master of Massacre	false
initiatives_localised_name_wh3_dlc20_character_initiative_chs_chaos_lord_sla_04	Living Nightmare	false
initiatives_localised_name_wh3_dlc20_character_initiative_chs_chaos_lord_sla_05	Impenetrable	false
initiatives_localised_name_wh3_dlc20_character_initiative_chs_chaos_lord_sla_06	Survivor	false
initiatives_localised_name_wh3_dlc20_character_initiative_chs_chaos_lord_sla_07	Mortal Supremacy	false
initiatives_localised_name_wh3_dlc20_character_initiative_chs_chaos_lord_sla_08	Indisputable Champion	false
initiatives_localised_name_wh3_dlc20_character_initiative_chs_chaos_lord_sla_09	Soul Harvester	false
initiatives_localised_name_wh3_dlc20_character_initiative_chs_chaos_lord_und_01	Unbreakable	false
initiatives_localised_name_wh3_dlc20_character_initiative_chs_chaos_lord_und_02	Master of Massacre	false
initiatives_localised_name_wh3_dlc20_character_initiative_chs_chaos_lord_und_03	Slayer of Champions	false
initiatives_localised_name_wh3_dlc20_character_initiative_chs_chaos_lord_und_04	Corrupter	false
initiatives_localised_name_wh3_dlc20_character_initiative_chs_chaos_lord_und_05	Impenetrable	false
initiatives_localised_name_wh3_dlc20_character_initiative_chs_chaos_lord_und_06	Survivor	false
initiatives_localised_name_wh3_dlc20_character_initiative_chs_chaos_lord_und_07	Mortal Supremacy	false
initiatives_localised_name_wh3_dlc20_character_initiative_chs_chaos_lord_und_08	Indisputable Champion	false
initiatives_localised_name_wh3_dlc20_character_initiative_chs_chaos_lord_und_09	Soul Harvester	false
initiatives_localised_name_wh3_dlc20_character_initiative_chs_chaos_sorcerer_lord_nur_01	Unbreakable	false
initiatives_localised_name_wh3_dlc20_character_initiative_chs_chaos_sorcerer_lord_nur_02	Partners in Chaos	false
initiatives_localised_name_wh3_dlc20_character_initiative_chs_chaos_sorcerer_lord_nur_03	Aspiring Leader	false
initiatives_localised_name_wh3_dlc20_character_initiative_chs_chaos_sorcerer_lord_nur_04	Wastelander	false
initiatives_localised_name_wh3_dlc20_character_initiative_chs_chaos_sorcerer_lord_nur_05	Aura of Atrophy	false
initiatives_localised_name_wh3_dlc20_character_initiative_chs_chaos_sorcerer_lord_nur_06	Favoured by Nurgle	false
initiatives_localised_name_wh3_dlc20_character_initiative_chs_chaos_sorcerer_lord_nur_07	Attuned to Shyish	false
initiatives_localised_name_wh3_dlc20_character_initiative_chs_chaos_sorcerer_lord_nur_08	Mortal Supremacy	false
initiatives_localised_name_wh3_dlc20_character_initiative_chs_chaos_sorcerer_lord_nur_09	Indisputable Champion	false
initiatives_localised_name_wh3_dlc20_character_initiative_chs_chaos_sorcerer_lord_nur_10	Soul Harvester	false
initiatives_localised_name_wh3_dlc20_character_initiative_chs_chaos_sorcerer_lord_tze_01	Unbreakable	false
initiatives_localised_name_wh3_dlc20_character_initiative_chs_chaos_sorcerer_lord_tze_02	Partners in Chaos	false
initiatives_localised_name_wh3_dlc20_character_initiative_chs_chaos_sorcerer_lord_tze_03	Aspiring Leader	false
initiatives_localised_name_wh3_dlc20_character_initiative_chs_chaos_sorcerer_lord_tze_04	Master Sorcerer	false
initiatives_localised_name_wh3_dlc20_character_initiative_chs_chaos_sorcerer_lord_tze_05	Arcane Exemplar	false
initiatives_localised_name_wh3_dlc20_character_initiative_chs_chaos_sorcerer_lord_tze_06	Attuned to Chamon	false
initiatives_localised_name_wh3_dlc20_character_initiative_chs_chaos_sorcerer_lord_tze_07	Favoured by Tzeentch	false
initiatives_localised_name_wh3_dlc20_character_initiative_chs_chaos_sorcerer_lord_tze_08	Mortal Supremacy	false
initiatives_localised_name_wh3_dlc20_character_initiative_chs_chaos_sorcerer_lord_tze_09	Indisputable Champion	false
initiatives_localised_name_wh3_dlc20_character_initiative_chs_chaos_sorcerer_lord_tze_10	Soul Harvester	false
initiatives_localised_name_wh3_dlc20_character_initiative_chs_chaos_sorcerer_lord_und_01	Unbreakable	false
initiatives_localised_name_wh3_dlc20_character_initiative_chs_chaos_sorcerer_lord_und_02	Partners in Chaos	false
initiatives_localised_name_wh3_dlc20_character_initiative_chs_chaos_sorcerer_lord_und_03	Aspiring Leader	false
initiatives_localised_name_wh3_dlc20_character_initiative_chs_chaos_sorcerer_lord_und_04	Unswayed by Change	false
initiatives_localised_name_wh3_dlc20_character_initiative_chs_chaos_sorcerer_lord_und_05	Unswayed by Decay	false
initiatives_localised_name_wh3_dlc20_character_initiative_chs_chaos_sorcerer_lord_und_06	Attuned to Chamon	false
initiatives_localised_name_wh3_dlc20_character_initiative_chs_chaos_sorcerer_lord_und_07	Attuned to Ulgu	false
initiatives_localised_name_wh3_dlc20_character_initiative_chs_chaos_sorcerer_lord_und_08	Mortal Supremacy	false
initiatives_localised_name_wh3_dlc20_character_initiative_chs_chaos_sorcerer_lord_und_09	Indisputable Champion	false
initiatives_localised_name_wh3_dlc20_character_initiative_chs_chaos_sorcerer_lord_und_10	Soul Harvester	false
initiatives_localised_name_wh3_dlc20_character_initiative_chs_chaos_sorcerer_sla_01	Unbreakable	false
initiatives_localised_name_wh3_dlc20_character_initiative_chs_chaos_sorcerer_sla_02	Partners in Chaos	false
initiatives_localised_name_wh3_dlc20_character_initiative_chs_chaos_sorcerer_sla_03	Hellstrider Leader	false
initiatives_localised_name_wh3_dlc20_character_initiative_chs_chaos_sorcerer_sla_04	Mage Hunter	false
initiatives_localised_name_wh3_dlc20_character_initiative_chs_chaos_sorcerer_sla_05	Living Nightmare	false
initiatives_localised_name_wh3_dlc20_character_initiative_chs_chaos_sorcerer_sla_06	Fiend Leader	false
initiatives_localised_name_wh3_dlc20_character_initiative_chs_chaos_sorcerer_sla_07	Favoured by Slaanesh	false
initiatives_localised_name_wh3_dlc20_character_initiative_chs_chaos_sorcerer_sla_08	Attuned to Ulgu	false
initiatives_localised_name_wh3_dlc20_character_initiative_chs_chaos_sorcerer_sla_09	Oppressive Force	false
initiatives_localised_name_wh3_dlc20_character_initiative_chs_chaos_sorcerer_sla_10	Mortal Prophet	false
initiatives_localised_name_wh3_dlc20_character_initiative_chs_chaos_sorcerer_tze_01	Unbreakable	false
initiatives_localised_name_wh3_dlc20_character_initiative_chs_chaos_sorcerer_tze_02	Partners in Chaos	false
initiatives_localised_name_wh3_dlc20_character_initiative_chs_chaos_sorcerer_tze_03	Master Sorcerer	false
initiatives_localised_name_wh3_dlc20_character_initiative_chs_chaos_sorcerer_tze_04	Mage Hunter	false
initiatives_localised_name_wh3_dlc20_character_initiative_chs_chaos_sorcerer_tze_05	Arcane Exemplar	false
initiatives_localised_name_wh3_dlc20_character_initiative_chs_chaos_sorcerer_tze_06	Shrouded in Chaos	false
initiatives_localised_name_wh3_dlc20_character_initiative_chs_chaos_sorcerer_tze_07	Attuned to Chamon	false
initiatives_localised_name_wh3_dlc20_character_initiative_chs_chaos_sorcerer_tze_08	Favoured by Tzeentch	false
initiatives_localised_name_wh3_dlc20_character_initiative_chs_chaos_sorcerer_tze_09	Oppressive Force	false
initiatives_localised_name_wh3_dlc20_character_initiative_chs_chaos_sorcerer_tze_10	Mortal Prophet	false
initiatives_localised_name_wh3_dlc20_character_initiative_chs_chaos_sorcerer_und_01	Unbreakable	false
initiatives_localised_name_wh3_dlc20_character_initiative_chs_chaos_sorcerer_und_02	Partners in Chaos	false
initiatives_localised_name_wh3_dlc20_character_initiative_chs_chaos_sorcerer_und_03	Corrupter	false
initiatives_localised_name_wh3_dlc20_character_initiative_chs_chaos_sorcerer_und_04	Mage Hunter	false
initiatives_localised_name_wh3_dlc20_character_initiative_chs_chaos_sorcerer_und_05	Unswayed by Excess	false
initiatives_localised_name_wh3_dlc20_character_initiative_chs_chaos_sorcerer_und_06	Unswayed by Change	false
initiatives_localised_name_wh3_dlc20_character_initiative_chs_chaos_sorcerer_und_07	Attuned to Chamon	false
initiatives_localised_name_wh3_dlc20_character_initiative_chs_chaos_sorcerer_und_08	Attuned to Ulgu	false
initiatives_localised_name_wh3_dlc20_character_initiative_chs_chaos_sorcerer_und_09	Oppressive Force	false
initiatives_localised_name_wh3_dlc20_character_initiative_chs_chaos_sorcerer_und_10	Mortal Prophet	false
initiatives_localised_name_wh3_dlc20_character_initiative_chs_daemon_prince_kho_01	Unbreakable	false
initiatives_localised_name_wh3_dlc20_character_initiative_chs_daemon_prince_kho_02	Slaughterlord	false
initiatives_localised_name_wh3_dlc20_character_initiative_chs_daemon_prince_kho_03	Master of Massacre	false
initiatives_localised_name_wh3_dlc20_character_initiative_chs_daemon_prince_kho_04	Mortal Supremacy	false
initiatives_localised_name_wh3_dlc20_character_initiative_chs_daemon_prince_kho_05	Murderous	false
initiatives_localised_name_wh3_dlc20_character_initiative_chs_daemon_prince_kho_06	Impenetrable	false
initiatives_localised_name_wh3_dlc20_character_initiative_chs_daemon_prince_kho_07	Survivor	false
initiatives_localised_name_wh3_dlc20_character_initiative_chs_daemon_prince_kho_08	Indisputable Champion	false
initiatives_localised_name_wh3_dlc20_character_initiative_chs_daemon_prince_kho_09	Soul Harvester	false
initiatives_localised_name_wh3_dlc20_character_initiative_chs_daemon_prince_nur_01	Unbreakable	false
initiatives_localised_name_wh3_dlc20_character_initiative_chs_daemon_prince_nur_02	Partners in Chaos	false
initiatives_localised_name_wh3_dlc20_character_initiative_chs_daemon_prince_nur_03	Master of Massacre	false
initiatives_localised_name_wh3_dlc20_character_initiative_chs_daemon_prince_nur_04	Mortal Supremacy	false
initiatives_localised_name_wh3_dlc20_character_initiative_chs_daemon_prince_nur_05	Murderous	false
initiatives_localised_name_wh3_dlc20_character_initiative_chs_daemon_prince_nur_06	Favoured by Nurgle	false
initiatives_localised_name_wh3_dlc20_character_initiative_chs_daemon_prince_nur_07	Survivor	false
initiatives_localised_name_wh3_dlc20_character_initiative_chs_daemon_prince_nur_08	Indisputable Champion	false
initiatives_localised_name_wh3_dlc20_character_initiative_chs_daemon_prince_nur_09	Soul Harvester	false
initiatives_localised_name_wh3_dlc20_character_initiative_chs_daemon_prince_sla_01	Unbreakable	false
initiatives_localised_name_wh3_dlc20_character_initiative_chs_daemon_prince_sla_02	Partners in Chaos	false
initiatives_localised_name_wh3_dlc20_character_initiative_chs_daemon_prince_sla_03	Master of Massacre	false
initiatives_localised_name_wh3_dlc20_character_initiative_chs_daemon_prince_sla_04	Mortal Supremacy	false
initiatives_localised_name_wh3_dlc20_character_initiative_chs_daemon_prince_sla_05	Murderous	false
initiatives_localised_name_wh3_dlc20_character_initiative_chs_daemon_prince_sla_06	Favoured by Slaanesh	false
initiatives_localised_name_wh3_dlc20_character_initiative_chs_daemon_prince_sla_07	Survivor	false
initiatives_localised_name_wh3_dlc20_character_initiative_chs_daemon_prince_sla_08	Indisputable Champion	false
initiatives_localised_name_wh3_dlc20_character_initiative_chs_daemon_prince_sla_09	Soul Harvester	false
initiatives_localised_name_wh3_dlc20_character_initiative_chs_daemon_prince_tze_01	Unbreakable	false
initiatives_localised_name_wh3_dlc20_character_initiative_chs_daemon_prince_tze_02	Partners in Chaos	false
initiatives_localised_name_wh3_dlc20_character_initiative_chs_daemon_prince_tze_03	Master Sorcerer	false
initiatives_localised_name_wh3_dlc20_character_initiative_chs_daemon_prince_tze_04	Mortal Supremacy	false
initiatives_localised_name_wh3_dlc20_character_initiative_chs_daemon_prince_tze_05	Murderous	false
initiatives_localised_name_wh3_dlc20_character_initiative_chs_daemon_prince_tze_06	Favoured by Tzeentch	false
initiatives_localised_name_wh3_dlc20_character_initiative_chs_daemon_prince_tze_07	Survivor	false
initiatives_localised_name_wh3_dlc20_character_initiative_chs_daemon_prince_tze_08	Indisputable Champion	false
initiatives_localised_name_wh3_dlc20_character_initiative_chs_daemon_prince_tze_09	Soul Harvester	false
initiatives_localised_name_wh3_dlc20_character_initiative_chs_daemon_prince_und_01	Unbreakable	false
initiatives_localised_name_wh3_dlc20_character_initiative_chs_daemon_prince_und_02	Partners in Chaos	false
initiatives_localised_name_wh3_dlc20_character_initiative_chs_daemon_prince_und_03	Master of Massacre	false
initiatives_localised_name_wh3_dlc20_character_initiative_chs_daemon_prince_und_04	Mortal Supremacy	false
initiatives_localised_name_wh3_dlc20_character_initiative_chs_daemon_prince_und_05	Murderous	false
initiatives_localised_name_wh3_dlc20_character_initiative_chs_daemon_prince_und_06	Pyromancer	false
initiatives_localised_name_wh3_dlc20_character_initiative_chs_daemon_prince_und_07	Survivor	false
initiatives_localised_name_wh3_dlc20_character_initiative_chs_daemon_prince_und_08	Indisputable Champion	false
initiatives_localised_name_wh3_dlc20_character_initiative_chs_daemon_prince_und_09	Soul Harvester	false
initiatives_localised_name_wh3_dlc20_character_initiative_chs_exalted_hero_kho_01	Unbreakable	false
initiatives_localised_name_wh3_dlc20_character_initiative_chs_exalted_hero_kho_02	Chaos Knight Leader	false
initiatives_localised_name_wh3_dlc20_character_initiative_chs_exalted_hero_kho_03	Skullcrusher Leader	false
initiatives_localised_name_wh3_dlc20_character_initiative_chs_exalted_hero_kho_04	Slaughterlord	false
initiatives_localised_name_wh3_dlc20_character_initiative_chs_exalted_hero_kho_05	Master of Massacre	false
initiatives_localised_name_wh3_dlc20_character_initiative_chs_exalted_hero_kho_06	Mage Hunter	false
initiatives_localised_name_wh3_dlc20_character_initiative_chs_exalted_hero_kho_07	Survivor	false
initiatives_localised_name_wh3_dlc20_character_initiative_chs_exalted_hero_kho_08	Chosen Leader	false
initiatives_localised_name_wh3_dlc20_character_initiative_chs_exalted_hero_kho_09	Mortal Champion	false
initiatives_localised_name_wh3_dlc20_character_initiative_chs_exalted_hero_kho_10	Chaos Assassin	false
initiatives_localised_name_wh3_dlc20_character_initiative_chs_exalted_hero_nur_01	Unbreakable	false
initiatives_localised_name_wh3_dlc20_character_initiative_chs_exalted_hero_nur_02	Chaos Knight Leader	false
initiatives_localised_name_wh3_dlc20_character_initiative_chs_exalted_hero_nur_03	Master of Massacre	false
initiatives_localised_name_wh3_dlc20_character_initiative_chs_exalted_hero_nur_04	Mage Hunter	false
initiatives_localised_name_wh3_dlc20_character_initiative_chs_exalted_hero_nur_05	Aura of Atrophy	false
initiatives_localised_name_wh3_dlc20_character_initiative_chs_exalted_hero_nur_06	Wastelander	false
initiatives_localised_name_wh3_dlc20_character_initiative_chs_exalted_hero_nur_07	Survivor	false
initiatives_localised_name_wh3_dlc20_character_initiative_chs_exalted_hero_nur_08	Chosen Leader	false
initiatives_localised_name_wh3_dlc20_character_initiative_chs_exalted_hero_nur_09	Mortal Champion	false
initiatives_localised_name_wh3_dlc20_character_initiative_chs_exalted_hero_nur_10	Chaos Assassin	false
initiatives_localised_name_wh3_dlc20_character_initiative_chs_exalted_hero_und_01	Unbreakable	false
initiatives_localised_name_wh3_dlc20_character_initiative_chs_exalted_hero_und_02	Chaos Knight Leader	false
initiatives_localised_name_wh3_dlc20_character_initiative_chs_exalted_hero_und_03	Master of Massacre	false
initiatives_localised_name_wh3_dlc20_character_initiative_chs_exalted_hero_und_04	Mage Hunter	false
initiatives_localised_name_wh3_dlc20_character_initiative_chs_exalted_hero_und_05	Corrupter	false
initiatives_localised_name_wh3_dlc20_character_initiative_chs_exalted_hero_und_06	Survivor	false
initiatives_localised_name_wh3_dlc20_character_initiative_chs_exalted_hero_und_07	Chosen Leader	false
initiatives_localised_name_wh3_dlc20_character_initiative_chs_exalted_hero_und_08	Mortal Champion	false
initiatives_localised_name_wh3_dlc20_character_initiative_chs_exalted_hero_und_09	Chaos Assassin	false
initiatives_localised_name_wh3_dlc20_character_initiative_devote_exalted_hero_to_khorne	Devote to Khorne	false
initiatives_localised_name_wh3_dlc20_character_initiative_devote_exalted_hero_to_nurgle	Devote to Nurgle	false
initiatives_localised_name_wh3_dlc20_character_initiative_devote_lord_to_khorne	Devote to Khorne	false
initiatives_localised_name_wh3_dlc20_character_initiative_devote_lord_to_nurgle	Devote to Nurgle	false
initiatives_localised_name_wh3_dlc20_character_initiative_devote_lord_to_slaanesh	Devote to Slaanesh	false
initiatives_localised_name_wh3_dlc20_character_initiative_devote_sorceror_lord_to_nurgle_death	Devote to Nurgle (Lore of Death)	false
initiatives_localised_name_wh3_dlc20_character_initiative_devote_sorceror_lord_to_nurgle_nurgle	Devote to Nurgle (Lore of Nurgle)	false
initiatives_localised_name_wh3_dlc20_character_initiative_devote_sorceror_lord_to_tzeentch_metal	Devote to Tzeentch (Lore of Metal)	false
initiatives_localised_name_wh3_dlc20_character_initiative_devote_sorceror_lord_to_tzeentch_tzeentch	Devote to Tzeentch (Lore of Tzeentch)	false
initiatives_localised_name_wh3_dlc20_character_initiative_devote_sorceror_to_slaanesh_shadows	Devote to Slaanesh (Lore of Shadows)	false
initiatives_localised_name_wh3_dlc20_character_initiative_devote_sorceror_to_slaanesh_slaanesh	Devote to Slaanesh (Lore of Slaanesh)	false
initiatives_localised_name_wh3_dlc20_character_initiative_devote_sorceror_to_tzeentch_metal	Devote to Tzeentch (Lore of Metal)	false
initiatives_localised_name_wh3_dlc20_character_initiative_devote_sorceror_to_tzeentch_tzeentch	Devote to Tzeentch (Lore of Tzeentch)	false
initiatives_localised_name_wh3_dlc20_faction_initiative_chs_khorne_1_army_xp	Slaughterers' Glory	false
initiatives_localised_name_wh3_dlc20_faction_initiative_chs_khorne_1_economy_post_battle_income	Death's Bounty	false
initiatives_localised_name_wh3_dlc20_faction_initiative_chs_khorne_1_units_bloodletters	Blessing of Blood	false
initiatives_localised_name_wh3_dlc20_faction_initiative_chs_khorne_1_units_flesh_hounds	Hellish Bite	false
initiatives_localised_name_wh3_dlc20_faction_initiative_chs_khorne_2_army_upgrades	Violent Hunger	false
initiatives_localised_name_wh3_dlc20_faction_initiative_chs_khorne_3_characters_marking	Annihilator's Armour	false
initiatives_localised_name_wh3_dlc20_faction_initiative_chs_khorne_3_units_skullcannons	Hellforged Fury	false
initiatives_localised_name_wh3_dlc20_faction_initiative_chs_khorne_3_units_warshrine	Brutal Worship	false
initiatives_localised_name_wh3_dlc20_faction_initiative_chs_khorne_5_units_bloodthirsters	Fists of Khorne	false
initiatives_localised_name_wh3_dlc20_faction_initiative_chs_khorne_5_units_soul_grinder	Murderous Mechanisms	false
initiatives_localised_name_wh3_dlc20_faction_initiative_chs_nurgle_1_army_replenishment	Deadly Transmission	false
initiatives_localised_name_wh3_dlc20_faction_initiative_chs_nurgle_1_economy_growth	Bloom of Decay	false
initiatives_localised_name_wh3_dlc20_faction_initiative_chs_nurgle_1_units_beast_of_nurgle	Blighted Beasts	false
initiatives_localised_name_wh3_dlc20_faction_initiative_chs_nurgle_1_units_plaguebearers	Rotting Retinue	false
initiatives_localised_name_wh3_dlc20_faction_initiative_chs_nurgle_2_army_upgrades	Desiccated Hide	false
initiatives_localised_name_wh3_dlc20_faction_initiative_chs_nurgle_3_characters_marking	Infectious Offering	false
initiatives_localised_name_wh3_dlc20_faction_initiative_chs_nurgle_3_units_plague_drones	Bubonic Swarm	false
initiatives_localised_name_wh3_dlc20_faction_initiative_chs_nurgle_3_units_warshrine	Contagious Worship	false
initiatives_localised_name_wh3_dlc20_faction_initiative_chs_nurgle_5_units_great_unclean_one	Pestilent Plaguefathers	false
initiatives_localised_name_wh3_dlc20_faction_initiative_chs_nurgle_5_units_soul_grinder	Grotesque Mechanisms	false
initiatives_localised_name_wh3_dlc20_faction_initiative_chs_slaanesh_1_army_movement	Endless March	false
initiatives_localised_name_wh3_dlc20_faction_initiative_chs_slaanesh_1_economy_control	Profit of Pleasure	false
initiatives_localised_name_wh3_dlc20_faction_initiative_chs_slaanesh_1_units_daemonettes	Joyous Degradation	false
initiatives_localised_name_wh3_dlc20_faction_initiative_chs_slaanesh_1_units_seeker_chariots	Exalted Chariots	false
initiatives_localised_name_wh3_dlc20_faction_initiative_chs_slaanesh_2_army_upgrades	Boon of Battle	false
initiatives_localised_name_wh3_dlc20_faction_initiative_chs_slaanesh_3_characters_marking	Explosive Sensation	false
initiatives_localised_name_wh3_dlc20_faction_initiative_chs_slaanesh_3_units_fiends	Fiendish Following	false
initiatives_localised_name_wh3_dlc20_faction_initiative_chs_slaanesh_3_units_warshrine	Salacious Worship	false
initiatives_localised_name_wh3_dlc20_faction_initiative_chs_slaanesh_5_units_keeper_of_secrets	Feast of Pain	false
initiatives_localised_name_wh3_dlc20_faction_initiative_chs_slaanesh_5_units_soul_grinder	Infernal Mechanisms	false
initiatives_localised_name_wh3_dlc20_faction_initiative_chs_tzeentch_1_army_winds	Tides of Magic	false
initiatives_localised_name_wh3_dlc20_faction_initiative_chs_tzeentch_1_economy_technology	Forbidden Knowledge	false
initiatives_localised_name_wh3_dlc20_faction_initiative_chs_tzeentch_1_units_pink_horrors	Whirling Destruction	false
initiatives_localised_name_wh3_dlc20_faction_initiative_chs_tzeentch_1_units_screamers	Horror of the Skies	false
initiatives_localised_name_wh3_dlc20_faction_initiative_chs_tzeentch_2_army_upgrades	Arcane Wisdom	false
initiatives_localised_name_wh3_dlc20_faction_initiative_chs_tzeentch_3_characters_marking	Arrows of Destiny	false
initiatives_localised_name_wh3_dlc20_faction_initiative_chs_tzeentch_3_units_flamers	Flames of Fate	false
initiatives_localised_name_wh3_dlc20_faction_initiative_chs_tzeentch_3_units_warshrine	Magical Worship	false
initiatives_localised_name_wh3_dlc20_faction_initiative_chs_tzeentch_5_units_lord_of_Change	Winged Watchers	false
initiatives_localised_name_wh3_dlc20_faction_initiative_chs_tzeentch_5_units_soul_grinder	Mysterious Mechanisms	false
initiatives_localised_name_wh3_dlc20_faction_initiative_chs_undivided_1_army_marauders	Raider's Raiment	false
initiatives_localised_name_wh3_dlc20_faction_initiative_chs_undivided_1_economy_building	Ruinous Bulwark	false
initiatives_localised_name_wh3_dlc20_faction_initiative_chs_undivided_1_units_furies	Fury of Chaos	false
initiatives_localised_name_wh3_dlc20_faction_initiative_chs_undivided_2_army_upgrades	Horrifying Presence	false
initiatives_localised_name_wh3_dlc20_faction_initiative_chs_undivided_2_economy_vassals	Undying Oath	false
initiatives_localised_name_wh3_dlc20_faction_initiative_chs_undivided_2_xp_sharing	Crown of Kings	false
initiatives_localised_name_wh3_dlc20_faction_initiative_chs_undivided_3_army_elites	Reaver's Reward	false
initiatives_localised_name_wh3_dlc20_faction_initiative_chs_undivided_3_characters_marking	Dark Portal	false
initiatives_localised_name_wh3_dlc20_faction_initiative_chs_undivided_3_units_hellcannons	Hail of Hellfire	false
initiatives_localised_name_wh3_dlc20_faction_initiative_chs_undivided_3_units_warshrine	Empowered Worship	false
initiatives_localised_name_wh3_dlc20_faction_initiative_chs_undivided_5_units_shaggoths	Carnage Incarnate	false
initiatives_localised_name_wh3_dlc23_faction_initiative_chd_category_bull_centaurs_1	Rune of Lifesteal	false
initiatives_localised_name_wh3_dlc23_faction_initiative_chd_category_bull_centaurs_2	Bound Daemon of Murder	false
initiatives_localised_name_wh3_dlc23_faction_initiative_chd_category_bull_centaurs_3	Visage of Fear	false
initiatives_localised_name_wh3_dlc23_faction_initiative_chd_category_bull_centaurs_4	Bound Barrier Daemon	false
initiatives_localised_name_wh3_dlc23_faction_initiative_chd_category_bull_centaurs_5	Bound Seeker Daemon	false
initiatives_localised_name_wh3_dlc23_faction_initiative_chd_category_bull_centaurs_6	Hell-Forged	false
initiatives_localised_name_wh3_dlc23_faction_initiative_chd_category_bull_centaurs_7	Soundproofed Armour	false
initiatives_localised_name_wh3_dlc23_faction_initiative_chd_category_bull_centaurs_8	Bound Blood Daemon	false
initiatives_localised_name_wh3_dlc23_faction_initiative_chd_category_flying_beasts_1	Soundproofed Armour	false
initiatives_localised_name_wh3_dlc23_faction_initiative_chd_category_flying_beasts_2	Blackshard Armour	false
initiatives_localised_name_wh3_dlc23_faction_initiative_chd_category_flying_beasts_3	Rune of Frenzy	false
initiatives_localised_name_wh3_dlc23_faction_initiative_chd_category_flying_beasts_4	Rune of Resistance	false
initiatives_localised_name_wh3_dlc23_faction_initiative_chd_category_flying_beasts_5	Bound Barrier Daemon	false
initiatives_localised_name_wh3_dlc23_faction_initiative_chd_category_flying_beasts_6	Bound Daemon of Murder	false
initiatives_localised_name_wh3_dlc23_faction_initiative_chd_category_flying_beasts_7	Chameleon Hide	false
initiatives_localised_name_wh3_dlc23_faction_initiative_chd_category_flying_beasts_8	Rune of Lifesteal	false
initiatives_localised_name_wh3_dlc23_faction_initiative_chd_category_kdaai_1	Bound Daemon of Murder	false
initiatives_localised_name_wh3_dlc23_faction_initiative_chd_category_kdaai_2	Bound Barrier Daemon	false
initiatives_localised_name_wh3_dlc23_faction_initiative_chd_category_kdaai_3	Strengthened Bindings	false
initiatives_localised_name_wh3_dlc23_faction_initiative_chd_category_kdaai_4	Bound Seeker Daemon	false
initiatives_localised_name_wh3_dlc23_faction_initiative_chd_category_kdaai_5	Rune of Shielding	false
initiatives_localised_name_wh3_dlc23_faction_initiative_chd_category_kdaai_6	Bound Resilience Daemon	false
initiatives_localised_name_wh3_dlc23_faction_initiative_chd_category_kdaai_7	Channeled Vigour	false
initiatives_localised_name_wh3_dlc23_faction_initiative_chd_category_kdaai_8	Furnace Fire	false
initiatives_localised_name_wh3_dlc23_faction_initiative_chd_category_melee_infantry_1	Rune of Resistance	false
initiatives_localised_name_wh3_dlc23_faction_initiative_chd_category_melee_infantry_2	Rune of Frenzy	false
initiatives_localised_name_wh3_dlc23_faction_initiative_chd_category_melee_infantry_3	Glittering Scales	false
initiatives_localised_name_wh3_dlc23_faction_initiative_chd_category_melee_infantry_4	Bound Resilience Daemon	false
initiatives_localised_name_wh3_dlc23_faction_initiative_chd_category_melee_infantry_5	Bound Fear Daemon	false
initiatives_localised_name_wh3_dlc23_faction_initiative_chd_category_melee_infantry_6	Rune of Sundering	false
initiatives_localised_name_wh3_dlc23_faction_initiative_chd_category_melee_infantry_7	Rune of Immunity	false
initiatives_localised_name_wh3_dlc23_faction_initiative_chd_category_melee_infantry_8	Rune of Reflection	false
initiatives_localised_name_wh3_dlc23_faction_initiative_chd_category_missile_infantry_1	Suppressing Ammunition	false
initiatives_localised_name_wh3_dlc23_faction_initiative_chd_category_missile_infantry_2	Magical Imbuement	false
initiatives_localised_name_wh3_dlc23_faction_initiative_chd_category_missile_infantry_3	Soundproofed Armour	false
initiatives_localised_name_wh3_dlc23_faction_initiative_chd_category_missile_infantry_4	Extra Pouches	false
initiatives_localised_name_wh3_dlc23_faction_initiative_chd_category_missile_infantry_5	Rune of Immunity	false
initiatives_localised_name_wh3_dlc23_faction_initiative_chd_category_missile_infantry_6	Chameleon Hide	false
initiatives_localised_name_wh3_dlc23_faction_initiative_chd_category_missile_infantry_7	Extra Powder Bag	false
initiatives_localised_name_wh3_dlc23_faction_initiative_chd_category_missile_infantry_8	Calibrated Loading Mechanism	false
initiatives_localised_name_wh3_dlc23_faction_initiative_chd_category_warmachines_1	Furnace Fire	false
initiatives_localised_name_wh3_dlc23_faction_initiative_chd_category_warmachines_2	Bound Barrier Daemon	false
initiatives_localised_name_wh3_dlc23_faction_initiative_chd_category_warmachines_3	Rune of Immunity	false
initiatives_localised_name_wh3_dlc23_faction_initiative_chd_category_warmachines_4	Strapped-On Ammo Crates	false
initiatives_localised_name_wh3_dlc23_faction_initiative_chd_category_warmachines_5	Blazing Body	false
initiatives_localised_name_wh3_dlc23_faction_initiative_chd_category_warmachines_6	Extra Powder Bags	false
initiatives_localised_name_wh3_dlc23_faction_initiative_chd_category_warmachines_7	Extra Ammunition Storage	false
initiatives_localised_name_wh3_dlc23_faction_initiative_chd_category_warmachines_8	Hellbindings	false
initiatives_localised_name_wh3_dlc23_faction_initiative_chd_category_warmachines_carriage_dummy_1	Extra Carriage Slot	false
initiatives_localised_name_wh3_dlc23_faction_initiative_chd_category_warmachines_carriage_dummy_2	Extra Carriage Slot	false
initiatives_localised_name_wh3_dlc24_character_initiative_chs_chaos_lord_tze_01	{{tr:initiatives_localised_name_wh3_dlc20_character_initiative_chs_chaos_lord_kho_01}}	false
initiatives_localised_name_wh3_dlc24_character_initiative_chs_chaos_lord_tze_02	{{tr:initiatives_localised_name_wh3_dlc20_character_initiative_chs_chaos_sorcerer_lord_tze_05}}	false
initiatives_localised_name_wh3_dlc24_character_initiative_chs_chaos_lord_tze_03	{{tr:initiatives_localised_name_wh3_dlc20_character_initiative_chs_chaos_lord_kho_03}}	false
initiatives_localised_name_wh3_dlc24_character_initiative_chs_chaos_lord_tze_04	{{tr:initiatives_localised_name_wh3_dlc20_character_initiative_chs_chaos_sorcerer_lord_tze_06}}	false
initiatives_localised_name_wh3_dlc24_character_initiative_chs_chaos_lord_tze_05	{{tr:initiatives_localised_name_wh3_dlc20_character_initiative_chs_chaos_lord_kho_05}}	false
initiatives_localised_name_wh3_dlc24_character_initiative_chs_chaos_lord_tze_06	{{tr:initiatives_localised_name_wh3_dlc20_character_initiative_chs_chaos_lord_kho_06}}	false
initiatives_localised_name_wh3_dlc24_character_initiative_chs_chaos_lord_tze_07	{{tr:initiatives_localised_name_wh3_dlc20_character_initiative_chs_chaos_lord_kho_07}}	false
initiatives_localised_name_wh3_dlc24_character_initiative_chs_chaos_lord_tze_08	{{tr:initiatives_localised_name_wh3_dlc20_character_initiative_chs_chaos_lord_kho_08}}	false
initiatives_localised_name_wh3_dlc24_character_initiative_chs_chaos_lord_tze_09	{{tr:initiatives_localised_name_wh3_dlc20_character_initiative_chs_chaos_lord_kho_09}}	false
initiatives_localised_name_wh3_dlc24_character_initiative_chs_exalted_hero_tze_01	{{tr:initiatives_localised_name_wh3_dlc20_character_initiative_chs_exalted_hero_kho_01}}	false
initiatives_localised_name_wh3_dlc24_character_initiative_chs_exalted_hero_tze_02	{{tr:initiatives_localised_name_wh3_dlc20_character_initiative_chs_exalted_hero_kho_02}}	false
initiatives_localised_name_wh3_dlc24_character_initiative_chs_exalted_hero_tze_03	{{tr:initiatives_localised_name_wh3_dlc20_character_initiative_chs_chaos_sorcerer_lord_tze_05}}	false
initiatives_localised_name_wh3_dlc24_character_initiative_chs_exalted_hero_tze_04	{{tr:initiatives_localised_name_wh3_dlc20_character_initiative_chs_chaos_sorcerer_lord_tze_06}}	false
initiatives_localised_name_wh3_dlc24_character_initiative_chs_exalted_hero_tze_05	{{tr:initiatives_localised_name_wh3_dlc20_character_initiative_chs_exalted_hero_kho_05}}	false
initiatives_localised_name_wh3_dlc24_character_initiative_chs_exalted_hero_tze_06	{{tr:initiatives_localised_name_wh3_dlc20_character_initiative_chs_exalted_hero_kho_06}}	false
initiatives_localised_name_wh3_dlc24_character_initiative_chs_exalted_hero_tze_07	{{tr:initiatives_localised_name_wh3_dlc20_character_initiative_chs_exalted_hero_kho_07}}	false
initiatives_localised_name_wh3_dlc24_character_initiative_chs_exalted_hero_tze_08	{{tr:initiatives_localised_name_wh3_dlc20_character_initiative_chs_exalted_hero_kho_08}}	false
initiatives_localised_name_wh3_dlc24_character_initiative_chs_exalted_hero_tze_09	{{tr:initiatives_localised_name_wh3_dlc20_character_initiative_chs_exalted_hero_kho_09}}	false
initiatives_localised_name_wh3_dlc24_character_initiative_chs_exalted_hero_tze_10	{{tr:initiatives_localised_name_wh3_dlc20_character_initiative_chs_exalted_hero_kho_10}}	false
initiatives_localised_name_wh3_dlc24_character_initiative_devote_exalted_hero_to_tzeentch	Devote to Tzeentch	false
initiatives_localised_name_wh3_dlc24_character_initiative_devote_lord_to_tzeentch	{{tr:initiatives_localised_name_wh3_dlc24_character_initiative_devote_exalted_hero_to_tzeentch}}	false
initiatives_localised_name_wh3_dlc24_faction_initiative_chs_tzeentch_3_units_changebringers	Flame Weavers	false
initiatives_localised_name_wh3_dlc24_faction_initiative_chs_tzeentch_3_units_cockatrice	Feathered Abominations	false
initiatives_localised_name_wh3_dlc24_faction_initiative_chs_tzeentch_3_units_mutalith_vortex_beast	Mystical Mutations	false
initiatives_localised_name_wh3_dlc25_character_initiative_chs_chaos_lord_nur_01	Unbreakable	false
initiatives_localised_name_wh3_dlc25_character_initiative_chs_chaos_lord_nur_02	Aura of Atrophy	false
initiatives_localised_name_wh3_dlc25_character_initiative_chs_chaos_lord_nur_03	Master of Massacre	false
initiatives_localised_name_wh3_dlc25_character_initiative_chs_chaos_lord_nur_04	Wastelander	false
initiatives_localised_name_wh3_dlc25_character_initiative_chs_chaos_lord_nur_05	Impenetrable	false
initiatives_localised_name_wh3_dlc25_character_initiative_chs_chaos_lord_nur_06	Survivor	false
initiatives_localised_name_wh3_dlc25_character_initiative_chs_chaos_lord_nur_07	Mortal Supremacy	false
initiatives_localised_name_wh3_dlc25_character_initiative_chs_chaos_lord_nur_08	Indisputable Champion	false
initiatives_localised_name_wh3_dlc25_character_initiative_chs_chaos_lord_nur_09	Soul Harvester	false
initiatives_localised_name_wh3_dlc25_character_initiative_chs_chaos_sorcerer_nur_01	Unbreakable	false
initiatives_localised_name_wh3_dlc25_character_initiative_chs_chaos_sorcerer_nur_02	Partners in Chaos	false
initiatives_localised_name_wh3_dlc25_character_initiative_chs_chaos_sorcerer_nur_03	Mage Hunter	false
initiatives_localised_name_wh3_dlc25_character_initiative_chs_chaos_sorcerer_nur_04	Wastelander	false
initiatives_localised_name_wh3_dlc25_character_initiative_chs_chaos_sorcerer_nur_05	Favoured by Nurgle	false
initiatives_localised_name_wh3_dlc25_character_initiative_chs_chaos_sorcerer_nur_06	Aura of Atrophy	false
initiatives_localised_name_wh3_dlc25_character_initiative_chs_chaos_sorcerer_nur_07	Master Sorcerer	false
initiatives_localised_name_wh3_dlc25_character_initiative_chs_chaos_sorcerer_nur_08	Oppressive Force	false
initiatives_localised_name_wh3_dlc25_character_initiative_chs_chaos_sorcerer_nur_09	Mortal Prophet	false
initiatives_localised_name_wh3_dlc25_character_initiative_devote_sorceror_to_nurgle_death	Devote to Nurgle (Lore of Death)	false
initiatives_localised_name_wh3_dlc25_character_initiative_devote_sorceror_to_nurgle_nurgle	Devote to Nurgle (Lore of Nurgle)	false
initiatives_localised_name_wh3_dlc25_faction_initiative_chs_nurgle_3_units_plague_ogres	Rotten Hunger	false
initiatives_localised_name_wh3_dlc25_faction_initiative_chs_nurgle_5_units_toad_dragon	Malignant Maws	false
initiatives_localised_name_wh3_main_character_initiative_ogr_big_name_arsebelcher	Arsebelcher	false
initiatives_localised_name_wh3_main_character_initiative_ogr_big_name_beastkiller	Beastkiller 	false
initiatives_localised_name_wh3_main_character_initiative_ogr_big_name_beastrider	Beastrider	false
initiatives_localised_name_wh3_main_character_initiative_ogr_big_name_bellyslapper	Bellyslapper	false
initiatives_localised_name_wh3_main_character_initiative_ogr_big_name_bigbellower	Bigbellower	false
initiatives_localised_name_wh3_main_character_initiative_ogr_big_name_bonechewer	Bonechewer	false
initiatives_localised_name_wh3_main_character_initiative_ogr_big_name_boommaker	Boommaker	false
initiatives_localised_name_wh3_main_character_initiative_ogr_big_name_brawlerguts	Brawlerguts	false
initiatives_localised_name_wh3_main_character_initiative_ogr_big_name_campmaker	Campmaker	false
initiatives_localised_name_wh3_main_character_initiative_ogr_big_name_chaos_slayer	Chaos-Slayer	false
initiatives_localised_name_wh3_main_character_initiative_ogr_big_name_daemonbreaker	Daemonbreaker	false
initiatives_localised_name_wh3_main_character_initiative_ogr_big_name_deathcheater	Deathcheater	false
initiatives_localised_name_wh3_main_character_initiative_ogr_big_name_dwarfsquasher	Dwarfsquasher	false
initiatives_localised_name_wh3_main_character_initiative_ogr_big_name_elfmulcher	Elfmulcher	false
initiatives_localised_name_wh3_main_character_initiative_ogr_big_name_giantbreaker	Giantbreaker	false
initiatives_localised_name_wh3_main_character_initiative_ogr_big_name_gnoblarkicker	Gnoblarkicker	false
initiatives_localised_name_wh3_main_character_initiative_ogr_big_name_goldhoarder	Goldhoarder 	false
initiatives_localised_name_wh3_main_character_initiative_ogr_big_name_grandfeaster	Grandfeaster	false
initiatives_localised_name_wh3_main_character_initiative_ogr_big_name_greasus_gatecrasher	Gatecrasher	false
initiatives_localised_name_wh3_main_character_initiative_ogr_big_name_greasus_hoardmaster	Hoardmaster	false
initiatives_localised_name_wh3_main_character_initiative_ogr_big_name_greasus_shockingly_obese	Shockingly Obese	false
initiatives_localised_name_wh3_main_character_initiative_ogr_big_name_greasus_tradelord	Tradelord	false
initiatives_localised_name_wh3_main_character_initiative_ogr_big_name_groundbreaker	Groundbreaker 	false
initiatives_localised_name_wh3_main_character_initiative_ogr_big_name_gutcrusher	Gutcrusher	false
initiatives_localised_name_wh3_main_character_initiative_ogr_big_name_kineater	Kineater	false
initiatives_localised_name_wh3_main_character_initiative_ogr_big_name_lizardstrangler	Lizardstrangler	false
initiatives_localised_name_wh3_main_character_initiative_ogr_big_name_longstrider	Longstrider	false
initiatives_localised_name_wh3_main_character_initiative_ogr_big_name_magichunter	Magic Hunter	false
initiatives_localised_name_wh3_main_character_initiative_ogr_big_name_maneater	Maneater	false
initiatives_localised_name_wh3_main_character_initiative_ogr_big_name_mawseeker	Mawseeker	false
initiatives_localised_name_wh3_main_character_initiative_ogr_big_name_mountaineater	Mountaineater	false
initiatives_localised_name_wh3_main_character_initiative_ogr_big_name_mountaintalker	Mountaintalker	false
initiatives_localised_name_wh3_main_character_initiative_ogr_big_name_ogrekiller	Ogrekiller	false
initiatives_localised_name_wh3_main_character_initiative_ogr_big_name_orcsplitter	Orcsplitter	false
initiatives_localised_name_wh3_main_character_initiative_ogr_big_name_ratkiller	Ratkiller	false
initiatives_localised_name_wh3_main_character_initiative_ogr_big_name_skrag_ever_famished	Ever-Famished	false
initiatives_localised_name_wh3_main_character_initiative_ogr_big_name_skrag_gore_harvester	Gore-Harvester	false
initiatives_localised_name_wh3_main_character_initiative_ogr_big_name_skrag_maw_that_walks	Maw-that-Walks	false
initiatives_localised_name_wh3_main_character_initiative_ogr_big_name_skrag_world_swallower	World-Swallower	false
initiatives_localised_name_wh3_main_character_initiative_ogr_big_name_staydeader	Staydeader	false
initiatives_localised_name_wh3_main_character_initiative_ogr_big_name_wallcrusher	Wallcrusher	false
initiatives_localised_name_wh3_pro11_character_initiative_chs_harald_hammerstorm_01	One True Hammer	false
initiatives_localised_name_wh3_pro11_character_initiative_chs_harald_hammerstorm_02	Deadbane	false
initiatives_localised_name_wh3_pro11_character_initiative_chs_harald_hammerstorm_03	No One's Fool	false
