key	text	tooltip
#Loc;1;text/db/projectile_shot_type_displays__.loc		
projectile_shot_type_displays_onscreen_name_bolt_thrower_multi_shot	Multi-Shot Round	false
projectile_shot_type_displays_onscreen_name_bolt_thrower_single_shot	Single-Shot Round	false
projectile_shot_type_displays_onscreen_name_deathshrieker_cluster	Deathshrieker Rocket	false
projectile_shot_type_displays_onscreen_name_deathshrieker_demolition	Demolition Rocket	false
projectile_shot_type_displays_onscreen_name_dwf_cannon_ball	{{tr:projectile_cannon_ball_name}}	false
projectile_shot_type_displays_onscreen_name_dwf_cannon_grape_shot	{{tr:projectile_grapeshot_name}}	false
projectile_shot_type_displays_onscreen_name_dwf_flame_cannon_flame	Single-Shot Projectile	false
projectile_shot_type_displays_onscreen_name_dwf_flame_cannon_splitting	Splitting Projectile	false
projectile_shot_type_displays_onscreen_name_emp_great_cannon_ball	{{tr:projectile_cannon_ball_name}}	false
projectile_shot_type_displays_onscreen_name_emp_great_cannon_grape_shot	{{tr:projectile_grapeshot_name}}	false
projectile_shot_type_displays_onscreen_name_ksl_little_grom	{{tr:projectile_cannon_ball_name}}	false
projectile_shot_type_displays_onscreen_name_ksl_little_grom_explosive	Thunder God Shells	false
projectile_shot_type_displays_onscreen_name_placeholder	placeholder	false
projectile_shot_type_displays_onscreen_name_talon_of_dawn	Talon of Dawn	false
projectile_shot_type_displays_onscreen_name_talon_of_dusk	Talon of Dusk	false
projectile_shot_type_displays_onscreen_name_wh_emp_rifle_repeater_bullet_upgraded_engineer	Piercing Shots	false
projectile_shot_type_displays_onscreen_name_wh_emp_rifle_repeater_bullet_upgraded_engineer_exploding	Blazing Shots	false
projectile_shot_type_displays_tooltip_text_bolt_thrower_multi_shot	Shooting many smaller projectiles instead of one large one is more effective when fighting multiple small targets, such as infantry units.	false
projectile_shot_type_displays_tooltip_text_bolt_thrower_single_shot	Shooting a single, large projectile instead of many smaller ones is more effective when fighting larger single targets, such as monsters.	false
projectile_shot_type_displays_tooltip_text_deathshrieker_cluster	The Deathshrieker Rocket is made up of multiple packed warheads, which detonate in the air above the battlefield in a storm of fire and plunge multiple tendrils of flame downwards from the blast.	false
projectile_shot_type_displays_tooltip_text_deathshrieker_demolition	Demolition Rockets use densely packed explosive warheads with delayed fuses in a strengthened iron tube to channel the blast against a single point.	false
projectile_shot_type_displays_tooltip_text_dwf_cannon_ball	{{tr:projectile_cannon_ball_description}}	false
projectile_shot_type_displays_tooltip_text_dwf_cannon_grape_shot	{{tr:projectile_grapeshot_description}}	false
projectile_shot_type_displays_tooltip_text_dwf_flame_cannon_flame	A single, large piece of ordnance, designed to maim and kill, en masse, on contact.	false
projectile_shot_type_displays_tooltip_text_dwf_flame_cannon_splitting	Due to this projectile's fiendish design, whichever direction you choose to run is the wrong one!	false
projectile_shot_type_displays_tooltip_text_emp_great_cannon_ball	{{tr:projectile_cannon_ball_description}}	false
projectile_shot_type_displays_tooltip_text_emp_great_cannon_grape_shot	{{tr:projectile_grapeshot_description}}	false
projectile_shot_type_displays_tooltip_text_ksl_little_grom	{{tr:projectile_cannon_ball_description}}	false
projectile_shot_type_displays_tooltip_text_ksl_little_grom_explosive	Made using secret techniques, these shells strike with a crack and rumble that mirrors Tor's mighty lightning, shattering clustered foes.	false
projectile_shot_type_displays_tooltip_text_placeholder	placeholder	false
projectile_shot_type_displays_tooltip_text_talon_of_dawn	Bolts of blessed light melt through armour to sear the flesh beneath.	false
projectile_shot_type_displays_tooltip_text_talon_of_dusk	Once loosed, these arrows splinter into scores of poisonous thorns that seek the flesh of Athel Lorenâ€™s enemies.	false
projectile_shot_type_displays_tooltip_text_wh_emp_rifle_repeater_bullet_upgraded_engineer	Engineers have refined both rifle and shot to guarantee the highest possible propulsion and penetration.	false
projectile_shot_type_displays_tooltip_text_wh_emp_rifle_repeater_bullet_upgraded_engineer_exploding	The gunpowder used in these shots is so volatile that it often explodes before reaching the target. Get as close as you can before firing, but not *too* close!	false
