key	text	tooltip
#Loc;1;text/db/provinces__.loc		
provinces_onscreen_wh3_dlc20_chaos_province_albion	Albion	false
provinces_onscreen_wh3_dlc20_chaos_province_marches_of_couronne	Marches of Couronne	false
provinces_onscreen_wh3_dlc20_chaos_province_middle_mountains	Middle Mountains	false
provinces_onscreen_wh3_dlc20_chaos_province_northern_wasteland	Northern Wasteland	false
provinces_onscreen_wh3_dlc20_combi_province_frigid_wasteland	The Frigid Wasteland	false
provinces_onscreen_wh3_dlc20_combi_province_middle_mountains	The Middle Mountains	false
provinces_onscreen_wh3_dlc23_chaos_province_dragon_isles	The Dragon Isles	false
provinces_onscreen_wh3_dlc23_chaos_province_gnoblar_country	Gnoblar Country	false
provinces_onscreen_wh3_dlc23_chaos_province_scalded_delta	Scalded Delta	false
provinces_onscreen_wh3_dlc23_chaos_province_silver_road	The Silver Road	false
provinces_onscreen_wh3_dlc23_chaos_province_the_plain_of_bones	The Plain of Bones	false
provinces_onscreen_wh3_main_chaos_province_ancient_giant_lands	Ancient Giant Lands	false
provinces_onscreen_wh3_main_chaos_province_black_blood_pass	Black Blood Pass	false
provinces_onscreen_wh3_main_chaos_province_black_water	Black Water	false
provinces_onscreen_wh3_main_chaos_province_bloodfire_falls	Bloodfire Falls	false
provinces_onscreen_wh3_main_chaos_province_bone_road	Bone Road	false
provinces_onscreen_wh3_main_chaos_province_broken_lands_of_tian_li	Broken Lands of Tian Li	false
provinces_onscreen_wh3_main_chaos_province_celestial_riverlands	Celestial Riverlands	false
provinces_onscreen_wh3_main_chaos_province_central_great_bastion	Central Great Bastion	false
provinces_onscreen_wh3_main_chaos_province_dukhlys_forest	Dukhlys Forest	false
provinces_onscreen_wh3_main_chaos_province_eastern_great_bastion	Eastern Great Bastion	false
provinces_onscreen_wh3_main_chaos_province_eastern_oblast	Eastern Oblast	false
provinces_onscreen_wh3_main_chaos_province_eastern_steppes	Eastern Steppes	false
provinces_onscreen_wh3_main_chaos_province_forests_of_the_moon	Forests of the Moon	false
provinces_onscreen_wh3_main_chaos_province_gash_kadrak	Gash Kadrak	false
provinces_onscreen_wh3_main_chaos_province_gianthome_mountains	Gianthome Mountains	false
provinces_onscreen_wh3_main_chaos_province_gunpowder_road	Gunpowder Road	false
provinces_onscreen_wh3_main_chaos_province_helspire_mountains	Helspire Mountains	false
provinces_onscreen_wh3_main_chaos_province_hochland	Hochland	false
provinces_onscreen_wh3_main_chaos_province_ice_pass	Ice Pass	false
provinces_onscreen_wh3_main_chaos_province_ice_tooth_mountains	Ice Tooth Mountains	false
provinces_onscreen_wh3_main_chaos_province_imperial_road	Imperial Road	false
provinces_onscreen_wh3_main_chaos_province_ivory_road	Ivory Road	false
provinces_onscreen_wh3_main_chaos_province_kdatha	K'datha	false
provinces_onscreen_wh3_main_chaos_province_lands_of_stone_and_steel	Lands of Stone and Steel	false
provinces_onscreen_wh3_main_chaos_province_middenland	Middenland	false
provinces_onscreen_wh3_main_chaos_province_mountains_of_hel	Mountains of Hel	false
provinces_onscreen_wh3_main_chaos_province_mountains_of_mourn	Mountains of Mourn	false
provinces_onscreen_wh3_main_chaos_province_nordland	Nordland	false
provinces_onscreen_wh3_main_chaos_province_northern_grey_mountains	Northern Grey Mountains	false
provinces_onscreen_wh3_main_chaos_province_northern_oblast	Northern Oblast	false
provinces_onscreen_wh3_main_chaos_province_northern_wastes	Northern Wastes	false
provinces_onscreen_wh3_main_chaos_province_ostermark	Ostermark	false
provinces_onscreen_wh3_main_chaos_province_ostland	Ostland	false
provinces_onscreen_wh3_main_chaos_province_path_to_the_east	Path to the East	false
provinces_onscreen_wh3_main_chaos_province_peak_pass	Peak Pass	false
provinces_onscreen_wh3_main_chaos_province_plain_of_bone	Plain of Bone	false
provinces_onscreen_wh3_main_chaos_province_plain_of_illusions	Plain of Illusions	false
provinces_onscreen_wh3_main_chaos_province_reikland	Reikland	false
provinces_onscreen_wh3_main_chaos_province_river_lynsk	River Lynsk	false
provinces_onscreen_wh3_main_chaos_province_river_urskoy	River Urskoy	false
provinces_onscreen_wh3_main_chaos_province_road_of_skulls	Road of Skulls	false
provinces_onscreen_wh3_main_chaos_province_road_to_damnation	Road to Damnation	false
provinces_onscreen_wh3_main_chaos_province_southern_grey_mountains	Southern Grey Mountains	false
provinces_onscreen_wh3_main_chaos_province_stirland	Stirland	false
provinces_onscreen_wh3_main_chaos_province_sylvania	Sylvania	false
provinces_onscreen_wh3_main_chaos_province_talabecland	Talabecland	false
provinces_onscreen_wh3_main_chaos_province_the_blasted_wastes	The Blasted Wastes	false
provinces_onscreen_wh3_main_chaos_province_the_blood_marshes	The Blood Marshes	false
provinces_onscreen_wh3_main_chaos_province_the_cliffs_of_death	The Cliffs of Death	false
provinces_onscreen_wh3_main_chaos_province_the_cold_mires	The Cold Mires	false
provinces_onscreen_wh3_main_chaos_province_the_cursed_city	The Cursed City	false
provinces_onscreen_wh3_main_chaos_province_the_eternal_lagoon	The Eternal Lagoon	false
provinces_onscreen_wh3_main_chaos_province_the_goromadny	The Goromadny	false
provinces_onscreen_wh3_main_chaos_province_the_great_maw	Wyrm Pass	false
provinces_onscreen_wh3_main_chaos_province_the_haunted_forest	The Haunted Forest	false
provinces_onscreen_wh3_main_chaos_province_the_high_pass	The High Pass	false
provinces_onscreen_wh3_main_chaos_province_the_howling_wastes	The Howling Wastes	false
provinces_onscreen_wh3_main_chaos_province_the_plain_of_zharr	The Plain of Zharr	false
provinces_onscreen_wh3_main_chaos_province_the_red_wastes	The Red Wastes	false
provinces_onscreen_wh3_main_chaos_province_the_shard_lands	The Shard Lands	false
provinces_onscreen_wh3_main_chaos_province_the_wasteland	The Wasteland	false
provinces_onscreen_wh3_main_chaos_province_the_witchs_wood	The Witch's Wood	false
provinces_onscreen_wh3_main_chaos_province_the_wolf_lands	The Wolf Lands	false
provinces_onscreen_wh3_main_chaos_province_troll_country	Troll Country	false
provinces_onscreen_wh3_main_chaos_province_trollheim_mountains	Trollheim Mountains	false
provinces_onscreen_wh3_main_chaos_province_vanaheim_mountains	Vanaheim Mountains	false
provinces_onscreen_wh3_main_chaos_province_warpstone_desert	Warpstone Desert	false
provinces_onscreen_wh3_main_chaos_province_wastelands_of_jinshen	Wastelands of Jinshen	false
provinces_onscreen_wh3_main_chaos_province_western_great_bastion	Western Great Bastion	false
provinces_onscreen_wh3_main_chaos_province_wissenland	Wissenland	false
provinces_onscreen_wh3_main_chaos_province_worlds_edge_mountains	Worlds Edge Mountains	false
provinces_onscreen_wh3_main_chaos_province_zorn_uzkul	Zorn Uzkul	false
provinces_onscreen_wh3_main_combi_province_albion	Albion	false
provinces_onscreen_wh3_main_combi_province_ancient_giant_lands	Ancient Giant Lands	false
provinces_onscreen_wh3_main_combi_province_argwylon	Argwylon	false
provinces_onscreen_wh3_main_combi_province_ashen_coast	Ashen Coast	false
provinces_onscreen_wh3_main_combi_province_atalan_mountains	Atalan Mountains	false
provinces_onscreen_wh3_main_combi_province_avelorn	Avelorn	false
provinces_onscreen_wh3_main_combi_province_averland	Averland	false
provinces_onscreen_wh3_main_combi_province_axe_bite_pass	Axe Bite Pass	false
provinces_onscreen_wh3_main_combi_province_aymara_swamps	Aymara Swamps	false
provinces_onscreen_wh3_main_combi_province_barrier_idols	The Barrier Idols	false
provinces_onscreen_wh3_main_combi_province_barrows_of_cuileux	Barrows of Cuileux	false
provinces_onscreen_wh3_main_combi_province_bastonne	Bastonne	false
provinces_onscreen_wh3_main_combi_province_black_blood_pass	Black Blood Pass	false
provinces_onscreen_wh3_main_combi_province_black_mountains	Black Mountains	false
provinces_onscreen_wh3_main_combi_province_black_water	Black Water	false
provinces_onscreen_wh3_main_combi_province_blightwater	Blightwater	false
provinces_onscreen_wh3_main_combi_province_blood_river_valley	Blood River Valley	false
provinces_onscreen_wh3_main_combi_province_bloodfire_falls	Bloodfire Falls	false
provinces_onscreen_wh3_main_combi_province_bone_road	Bone Road	false
provinces_onscreen_wh3_main_combi_province_broken_lands_of_tian_li	Broken Lands of Tian Li	false
provinces_onscreen_wh3_main_combi_province_broken_teeth	Broken Teeth	false
provinces_onscreen_wh3_main_combi_province_caledor	Caledor	false
provinces_onscreen_wh3_main_combi_province_carcassonne	Carcassonne	false
provinces_onscreen_wh3_main_combi_province_cathayan_hinterlands	Cathayan Hinterlands	false
provinces_onscreen_wh3_main_combi_province_celestial_lake	Celestial Lake	false
provinces_onscreen_wh3_main_combi_province_celestial_riverlands	Celestial Riverlands	false
provinces_onscreen_wh3_main_combi_province_central_great_bastion	Central Great Bastion	false
provinces_onscreen_wh3_main_combi_province_central_jungles	Central Jungles	false
provinces_onscreen_wh3_main_combi_province_chimera_plateau	Chimera Plateau	false
provinces_onscreen_wh3_main_combi_province_chrace	Chrace	false
provinces_onscreen_wh3_main_combi_province_coast_of_araby	Coast of Araby	false
provinces_onscreen_wh3_main_combi_province_coast_of_lyonesse	Coast of Lyonesse	false
provinces_onscreen_wh3_main_combi_province_copper_desert	Copper Desert	false
provinces_onscreen_wh3_main_combi_province_cothique	Cothique	false
provinces_onscreen_wh3_main_combi_province_crater_of_the_waking_dead	Crater of the Waking Dead	false
provinces_onscreen_wh3_main_combi_province_culchan_plains	Culchan Plains	false
provinces_onscreen_wh3_main_combi_province_dawns_landing	Dawn's Landing	false
provinces_onscreen_wh3_main_combi_province_deadrock_gap	Deadrock Gap	false
provinces_onscreen_wh3_main_combi_province_deadwood	Deadwood	false
provinces_onscreen_wh3_main_combi_province_death_pass	Death Pass	false
provinces_onscreen_wh3_main_combi_province_devils_backbone	Devil's Backbone	false
provinces_onscreen_wh3_main_combi_province_doom_glades	Doom Glades	false
provinces_onscreen_wh3_main_combi_province_eagle_gate	Eagle Gate	false
provinces_onscreen_wh3_main_combi_province_eastern_badlands	Eastern Badlands	false
provinces_onscreen_wh3_main_combi_province_eastern_border_princes	Eastern Border Princes	false
provinces_onscreen_wh3_main_combi_province_eastern_colonies	Eastern Colonies	false
provinces_onscreen_wh3_main_combi_province_eastern_great_bastion	Eastern Great Bastion	false
provinces_onscreen_wh3_main_combi_province_eastern_oblast	Eastern Oblast	false
provinces_onscreen_wh3_main_combi_province_eastern_steppes	Eastern Steppes	false
provinces_onscreen_wh3_main_combi_province_eataine	Eataine	false
provinces_onscreen_wh3_main_combi_province_eight_peaks	Eight Peaks	false
provinces_onscreen_wh3_main_combi_province_ellyrion	Ellyrion	false
provinces_onscreen_wh3_main_combi_province_estalia	Estalia	false
provinces_onscreen_wh3_main_combi_province_forest_of_arden	Forest of Arden	false
provinces_onscreen_wh3_main_combi_province_forest_of_chalons	Forest of Chalons	false
provinces_onscreen_wh3_main_combi_province_forest_of_gloom	Forest of Gloom	false
provinces_onscreen_wh3_main_combi_province_forests_of_the_moon	Forests of the Moon	false
provinces_onscreen_wh3_main_combi_province_gash_kadrak	Gash Kadrak	false
provinces_onscreen_wh3_main_combi_province_gianthome_mountains	Gianthome Mountains	false
provinces_onscreen_wh3_main_combi_province_gisoreux_gap	Gisoreux Gap	false
provinces_onscreen_wh3_main_combi_province_gnoblar_country	Gnoblar Country	false
provinces_onscreen_wh3_main_combi_province_goromadny_mountains	Goromadny Mountains	false
provinces_onscreen_wh3_main_combi_province_granite_hills	Granite Hills	false
provinces_onscreen_wh3_main_combi_province_great_desert_of_araby	Great Desert of Araby	false
provinces_onscreen_wh3_main_combi_province_great_mortis_delta	Great Mortis Delta	false
provinces_onscreen_wh3_main_combi_province_griffon_gate	Griffon Gate	false
provinces_onscreen_wh3_main_combi_province_gryphon_wood	Gryphon Wood	false
provinces_onscreen_wh3_main_combi_province_gunpowder_road	Gunpowder Road	false
provinces_onscreen_wh3_main_combi_province_headhunters_jungle	Headhunter's Jungle	false
provinces_onscreen_wh3_main_combi_province_heart_of_the_jungle	Heart of the Jungle	false
provinces_onscreen_wh3_main_combi_province_helspire_mountains	Helspire Mountains	false
provinces_onscreen_wh3_main_combi_province_hochland	Hochland	false
provinces_onscreen_wh3_main_combi_province_ice_tooth_mountains	Ice Tooth Mountains	false
provinces_onscreen_wh3_main_combi_province_imperial_road	Imperial Road	false
provinces_onscreen_wh3_main_combi_province_iron_coast	Iron Coast	false
provinces_onscreen_wh3_main_combi_province_iron_foothills	Iron Foothills	false
provinces_onscreen_wh3_main_combi_province_iron_mountains	Iron Mountains	false
provinces_onscreen_wh3_main_combi_province_ironfrost_glacier	Ironfrost Glacier	false
provinces_onscreen_wh3_main_combi_province_ironsand_desert	Ironsand Desert	false
provinces_onscreen_wh3_main_combi_province_irrana_mountains	Irrana Mountains	false
provinces_onscreen_wh3_main_combi_province_isthmus_of_lustria	Isthmus of Lustria	false
provinces_onscreen_wh3_main_combi_province_ivory_road	Ivory Road	false
provinces_onscreen_wh3_main_combi_province_jade_river_delta	Jade River Delta	false
provinces_onscreen_wh3_main_combi_province_jungles_of_chian	Jungles of Chi'an	false
provinces_onscreen_wh3_main_combi_province_jungles_of_green_mist	Jungles of Green Mist	false
provinces_onscreen_wh3_main_combi_province_jungles_of_pahualaxa	Jungles of Pahualaxa	false
provinces_onscreen_wh3_main_combi_province_kdatha	K'datha	false
provinces_onscreen_wh3_main_combi_province_kingdom_of_beasts	Kingdom of Beasts	false
provinces_onscreen_wh3_main_combi_province_land_of_assassins	Land of Assassins	false
provinces_onscreen_wh3_main_combi_province_land_of_the_dead	Land of the Dead	false
provinces_onscreen_wh3_main_combi_province_land_of_the_dervishes	Land of the Dervishes	false
provinces_onscreen_wh3_main_combi_province_lands_of_stone_and_steel	Lands of Stone and Steel	false
provinces_onscreen_wh3_main_combi_province_marches_of_couronne	Marches of Couronne	false
provinces_onscreen_wh3_main_combi_province_marshes_of_madness	Marshes of Madness	false
provinces_onscreen_wh3_main_combi_province_middenland	Middenland	false
provinces_onscreen_wh3_main_combi_province_mootland	Mootland	false
provinces_onscreen_wh3_main_combi_province_mosquito_swamps	Mosquito Swamps	false
provinces_onscreen_wh3_main_combi_province_mount_li	Mount Li	false
provinces_onscreen_wh3_main_combi_province_mountains_of_hel	Mountains of Hel	false
provinces_onscreen_wh3_main_combi_province_mountains_of_mourn	Mountains of Mourn	false
provinces_onscreen_wh3_main_combi_province_mountains_of_naglfari	Mountains of Naglfari	false
provinces_onscreen_wh3_main_combi_province_mouth_of_ruin	Scalded Delta	false
provinces_onscreen_wh3_main_combi_province_nagarythe	Nagarythe	false
provinces_onscreen_wh3_main_combi_province_nongchang_basin	Nongchang Basin	false
provinces_onscreen_wh3_main_combi_province_nordland	Nordland	false
provinces_onscreen_wh3_main_combi_province_northern_grey_mountains	Northern Grey Mountains	false
provinces_onscreen_wh3_main_combi_province_northern_sylvania	Northern Sylvania	false
provinces_onscreen_wh3_main_combi_province_northern_wastes	Northern Wastes	false
provinces_onscreen_wh3_main_combi_province_northern_worlds_edge_mountains	Northern World's Edge Mountains	false
provinces_onscreen_wh3_main_combi_province_northern_yvresse	Northern Yvresse	false
provinces_onscreen_wh3_main_combi_province_obsidian_peaks	Obsidian Peaks	false
provinces_onscreen_wh3_main_combi_province_ostermark	Ostermark	false
provinces_onscreen_wh3_main_combi_province_ostland	Ostland	false
provinces_onscreen_wh3_main_combi_province_path_to_the_east	Path to the East	false
provinces_onscreen_wh3_main_combi_province_peak_pass	Peak Pass	false
provinces_onscreen_wh3_main_combi_province_phoenix_gate	Phoenix Gate	false
provinces_onscreen_wh3_main_combi_province_pirates_current	Pirate's Current	false
provinces_onscreen_wh3_main_combi_province_plain_of_illusions	Plain of Illusions	false
provinces_onscreen_wh3_main_combi_province_plains_of_xen	Plains of Xen	false
provinces_onscreen_wh3_main_combi_province_red_desert	Red Desert	false
provinces_onscreen_wh3_main_combi_province_reikland	Reikland	false
provinces_onscreen_wh3_main_combi_province_rib_peaks	Rib Peaks	false
provinces_onscreen_wh3_main_combi_province_river_brienne	River Brienne	false
provinces_onscreen_wh3_main_combi_province_river_lynsk	River Lynsk	false
provinces_onscreen_wh3_main_combi_province_river_qurveza	River Qurveza	false
provinces_onscreen_wh3_main_combi_province_river_urskoy	River Urskoy	false
provinces_onscreen_wh3_main_combi_province_saphery	Saphery	false
provinces_onscreen_wh3_main_combi_province_scorpion_coast	Piranha Swamps	false
provinces_onscreen_wh3_main_combi_province_serpent_estuary	Serpent Estuary	false
provinces_onscreen_wh3_main_combi_province_shifting_sands	Shifting Sands	false
provinces_onscreen_wh3_main_combi_province_solland	Solland	false
provinces_onscreen_wh3_main_combi_province_southern_badlands	Southern Badlands	false
provinces_onscreen_wh3_main_combi_province_southern_grey_mountains	Southern Grey Mountains	false
provinces_onscreen_wh3_main_combi_province_southern_jungles	Southern Jungles	false
provinces_onscreen_wh3_main_combi_province_southern_oblast	Southern Oblast	false
provinces_onscreen_wh3_main_combi_province_southern_sylvania	Southern Sylvania	false
provinces_onscreen_wh3_main_combi_province_southern_worlds_edge_mountains	Southern World's Edge Mountains	false
provinces_onscreen_wh3_main_combi_province_southern_yvresse	Southern Yvresse	false
provinces_onscreen_wh3_main_combi_province_southlands_worlds_edge_mountains	Southlands World's Edge Mountains	false
provinces_onscreen_wh3_main_combi_province_spine_of_sotek	Spine of Sotek	false
provinces_onscreen_wh3_main_combi_province_spiteful_peaks	Spiteful Peaks	false
provinces_onscreen_wh3_main_combi_province_stirland	Stirland	false
provinces_onscreen_wh3_main_combi_province_stonesky_foothills	Stonesky Foothills	false
provinces_onscreen_wh3_main_combi_province_talabecland	Talabecland	false
provinces_onscreen_wh3_main_combi_province_talsyn	Talsyn	false
provinces_onscreen_wh3_main_combi_province_the_abyssal_glacier	The Abyssal Glacier	false
provinces_onscreen_wh3_main_combi_province_the_black_flood	The Black Flood	false
provinces_onscreen_wh3_main_combi_province_the_blasted_wastes	The Blasted Wastes	false
provinces_onscreen_wh3_main_combi_province_the_bleak_coast	The Bleak Coast	false
provinces_onscreen_wh3_main_combi_province_the_blighted_marshes	The Blighted Marshes	false
provinces_onscreen_wh3_main_combi_province_the_blood_marshes	The Blood Marshes	false
provinces_onscreen_wh3_main_combi_province_the_broken_lands	The Broken Lands	false
provinces_onscreen_wh3_main_combi_province_the_capes	The Capes	false
provinces_onscreen_wh3_main_combi_province_the_clawed_coast	The Clawed Coast	false
provinces_onscreen_wh3_main_combi_province_the_cold_mires	The Cold Mires	false
provinces_onscreen_wh3_main_combi_province_the_cracked_land	The Cracked Land	false
provinces_onscreen_wh3_main_combi_province_the_creeping_jungle	The Creeping Jungle	false
provinces_onscreen_wh3_main_combi_province_the_cursed_city	The Cursed City	false
provinces_onscreen_wh3_main_combi_province_the_daemonium_hills	The Daemonium Hills	false
provinces_onscreen_wh3_main_combi_province_the_desolation_of_azgorh	The Desolation of Azgorh	false
provinces_onscreen_wh3_main_combi_province_the_dragon_isles	The Dragon Isles	false
provinces_onscreen_wh3_main_combi_province_the_eternal_lagoon	The Eternal Lagoon	false
provinces_onscreen_wh3_main_combi_province_the_forbidden_jungle	The Forbidden Jungle	false
provinces_onscreen_wh3_main_combi_province_the_golden_pass	The Golden Pass	false
provinces_onscreen_wh3_main_combi_province_the_great_canal	The Great Canal	false
provinces_onscreen_wh3_main_combi_province_the_great_ocean	The Great Ocean	false
provinces_onscreen_wh3_main_combi_province_the_gwangee_valley	The Gwangee Valley	false
provinces_onscreen_wh3_main_combi_province_the_haunted_forest	The Haunted Forest	false
provinces_onscreen_wh3_main_combi_province_the_howling_wastes	The Howling Wastes	false
provinces_onscreen_wh3_main_combi_province_the_ice_fire_plains	The Ice-Fire Plains	false
provinces_onscreen_wh3_main_combi_province_the_isthmus_coast	The Isthmus Coast	false
provinces_onscreen_wh3_main_combi_province_the_jungles_of_the_gods	The Jungles of the Gods	false
provinces_onscreen_wh3_main_combi_province_the_lost_valley	The Lost Valley	false
provinces_onscreen_wh3_main_combi_province_the_maw	Wyrm Pass	false
provinces_onscreen_wh3_main_combi_province_the_misty_hills	The Misty Hills	false
provinces_onscreen_wh3_main_combi_province_the_night_forest_road	The Night Forest Road	false
provinces_onscreen_wh3_main_combi_province_the_noisome_tumour	The Noisome Tumour	false
provinces_onscreen_wh3_main_combi_province_the_plain_of_bones	The Plain of Bones	false
provinces_onscreen_wh3_main_combi_province_the_plain_of_zharr	The Plain of Zharr	false
provinces_onscreen_wh3_main_combi_province_the_red_wastes	The Red Wastes	false
provinces_onscreen_wh3_main_combi_province_the_road_of_skulls	The Road of Skulls	false
provinces_onscreen_wh3_main_combi_province_the_sacred_pools	The Sacred Pools	false
provinces_onscreen_wh3_main_combi_province_the_shard_lands	The Shard Lands	false
provinces_onscreen_wh3_main_combi_province_the_silver_road	The Silver Road	false
provinces_onscreen_wh3_main_combi_province_the_skull_road	The Skull Road	false
provinces_onscreen_wh3_main_combi_province_the_southern_wastes	The Southern Wastes	false
provinces_onscreen_wh3_main_combi_province_the_turtle_isles	The Turtle Isles	false
provinces_onscreen_wh3_main_combi_province_the_vaults	The Vaults	false
provinces_onscreen_wh3_main_combi_province_the_wasteland	The Wasteland	false
provinces_onscreen_wh3_main_combi_province_the_witchs_wood	Laurelorn Forest	false
provinces_onscreen_wh3_main_combi_province_the_witchwood	The Witchwood	false
provinces_onscreen_wh3_main_combi_province_the_wolf_lands	The Wolf Lands	false
provinces_onscreen_wh3_main_combi_province_tilea	Tilea	false
provinces_onscreen_wh3_main_combi_province_tiranoc	Tiranoc	false
provinces_onscreen_wh3_main_combi_province_titan_peaks	Titan Peaks	false
provinces_onscreen_wh3_main_combi_province_torgovann	Torgovann	false
provinces_onscreen_wh3_main_combi_province_troll_country	Troll Country	false
provinces_onscreen_wh3_main_combi_province_trollheim_mountains	Trollheim Mountains	false
provinces_onscreen_wh3_main_combi_province_unicorn_gate	Unicorn Gate	false
provinces_onscreen_wh3_main_combi_province_vampire_coast	Jungle of Webs	false
provinces_onscreen_wh3_main_combi_province_vanaheim_mountains	Vanaheim Mountains	false
provinces_onscreen_wh3_main_combi_province_volcanic_islands	Volcanic Islands	false
provinces_onscreen_wh3_main_combi_province_warpstone_desert	Warpstone Desert	false
provinces_onscreen_wh3_main_combi_province_wastelands_of_jinshen	Wastelands of Jinshen	false
provinces_onscreen_wh3_main_combi_province_western_badlands	Western Badlands	false
provinces_onscreen_wh3_main_combi_province_western_border_princes	Western Border Princes	false
provinces_onscreen_wh3_main_combi_province_western_great_bastion	Western Great Bastion	false
provinces_onscreen_wh3_main_combi_province_western_jungles	Western Jungles	false
provinces_onscreen_wh3_main_combi_province_western_oblast	Western Oblast	false
provinces_onscreen_wh3_main_combi_province_winters_teeth_pass	Winter's Teeth Pass	false
provinces_onscreen_wh3_main_combi_province_wissenland	Wissenland	false
provinces_onscreen_wh3_main_combi_province_wydrioth	Wydrioth	false
provinces_onscreen_wh3_main_combi_province_yn_edri_eternos	Yn Edri Eternos	false
provinces_onscreen_wh3_main_combi_province_zorn_uzkul	Zorn Uzkul	false
provinces_onscreen_wh3_prologue_province_broken_lands	Broken Lands	false
provinces_onscreen_wh3_prologue_province_canyons_of_gore	Canyons of Gore	false
provinces_onscreen_wh3_prologue_province_crater_of_lies	Crater of Lies	false
provinces_onscreen_wh3_prologue_province_crimson_vale	Crimson Vale	false
provinces_onscreen_wh3_prologue_province_fleshlands	Fleshlands	false
provinces_onscreen_wh3_prologue_province_frozen_plains	Frozen Plains	false
provinces_onscreen_wh3_prologue_province_ice_canyon	Ice Canyon	false
provinces_onscreen_wh3_prologue_province_icecaid_pass	Icecaid Pass	false
provinces_onscreen_wh3_prologue_province_mirror_marches	Mirror Marches	false
provinces_onscreen_wh3_prologue_province_mountain_pass	Mountain Pass	false
provinces_onscreen_wh3_prologue_province_plains_of_brass	Plains of Brass	false
provinces_onscreen_wh3_prologue_province_river_of_the_flux	River of the Flux	false
provinces_onscreen_wh3_prologue_province_the_falls_of_circatrex	The Falls of Circatrex	false
provinces_onscreen_wh3_prologue_province_the_maze_keep	The Maze-Keep	false
provinces_onscreen_wh3_prologue_province_the_riven_moors	The Riven Moors	false
provinces_onscreen_wh3_prologue_province_the_scarlet_steppes	The Scarlet Steppes	false
provinces_onscreen_wh3_prologue_province_the_void_lands	The Void Lands	false
provinces_onscreen_wh3_prologue_province_the_void_steppes	The Void Steppes	false
