key	text	tooltip
#Loc;1;text/db/regions__.loc		
regions_battle_name_wh3_dlc20_chaos_region_black_pit	The Black Pit	false
regions_battle_name_wh3_dlc20_chaos_region_chantillon	Chantillon	false
regions_battle_name_wh3_dlc20_chaos_region_citadel_of_lead	Citadel of Lead	false
regions_battle_name_wh3_dlc20_chaos_region_fort_sollace	Fort Solace	false
regions_battle_name_wh3_dlc20_chaos_region_grung_zint	Grung Zint	false
regions_battle_name_wh3_dlc20_chaos_region_losteriksons_landing	Losterikson's Landing	false
regions_battle_name_wh3_dlc20_chaos_region_neuland	Neuland	false
regions_battle_name_wh3_dlc20_chaos_region_river_reik	River Reik	false
regions_battle_name_wh3_dlc20_chaos_region_tancred_castle	Tancred Castle	false
regions_battle_name_wh3_dlc20_chaos_region_wreckers_point	Wrecker's Point	false
regions_battle_name_wh3_dlc20_chaos_region_zanbaijin	Zanbaijin	false
regions_battle_name_wh3_dlc20_combi_region_dragons_death	Dragon's Death	false
regions_battle_name_wh3_dlc20_combi_region_glacial_gardens	The Glacial Gardens	false
regions_battle_name_wh3_dlc20_combi_region_glacier_encampment	Glacier Encampment	false
regions_battle_name_wh3_dlc20_combi_region_krudenwald	Krudenwald	false
regions_battle_name_wh3_main_chaos_region_altar_of_spawns	Altar of Spawns	false
regions_battle_name_wh3_main_chaos_region_altar_of_the_crimson_harvest	Altar of the Crimson Harvest	false
regions_battle_name_wh3_main_chaos_region_altdorf	Altdorf	false
regions_battle_name_wh3_main_chaos_region_amblepeak	Amblepeak	false
regions_battle_name_wh3_main_chaos_region_bay_of_blades	Bay of Blades	false
regions_battle_name_wh3_main_chaos_region_bechafen	Bechafen	false
regions_battle_name_wh3_main_chaos_region_black_fang	Black Fang	false
regions_battle_name_wh3_main_chaos_region_black_fortress	Black Fortress	false
regions_battle_name_wh3_main_chaos_region_black_gulch	Black Gulch	false
regions_battle_name_wh3_main_chaos_region_black_rock	Black Rock	false
regions_battle_name_wh3_main_chaos_region_blackstone_tower	Blackstone Tower	false
regions_battle_name_wh3_main_chaos_region_blizzardpeak	Blizzardpeak	false
regions_battle_name_wh3_main_chaos_region_blood_haven	Blood-Haven	false
regions_battle_name_wh3_main_chaos_region_blood_mountain	Blood Mountain	false
regions_battle_name_wh3_main_chaos_region_bloodpeak	Bloodpeak	false
regions_battle_name_wh3_main_chaos_region_bloodwind_keep	Bloodwind Keep	false
regions_battle_name_wh3_main_chaos_region_bohsenfels	Bohsenfels	false
regions_battle_name_wh3_main_chaos_region_bolgasgrad	Bolgasgrad	false
regions_battle_name_wh3_main_chaos_region_brass_keep	Brass Keep	false
regions_battle_name_wh3_main_chaos_region_bridge_of_brass	Bridge of Brass	false
regions_battle_name_wh3_main_chaos_region_bridge_of_heaven	Bridge of Heaven	false
regions_battle_name_wh3_main_chaos_region_broekwater	Broekwater	false
regions_battle_name_wh3_main_chaos_region_castle_alexandronov	Castle Alexandronov	false
regions_battle_name_wh3_main_chaos_region_castle_drachenfels	Castle Drachenfels	false
regions_battle_name_wh3_main_chaos_region_castle_drakenhof	Castle Drakenhof	false
regions_battle_name_wh3_main_chaos_region_chasm_of_torment	Chasm of Torment	false
regions_battle_name_wh3_main_chaos_region_chimera_plateau	Chimera Plateau	false
regions_battle_name_wh3_main_chaos_region_city_of_monkeys	City of Monkeys	false
regions_battle_name_wh3_main_chaos_region_city_of_splinters	City of Splinters	false
regions_battle_name_wh3_main_chaos_region_city_of_the_shugengan	City of the Shugengan	false
regions_battle_name_wh3_main_chaos_region_cliff_of_beasts	Cliff of Beasts	false
regions_battle_name_wh3_main_chaos_region_crookback_mountain	Crookback Mountain	false
regions_battle_name_wh3_main_chaos_region_darkhold	Darkhold	false
regions_battle_name_wh3_main_chaos_region_delberz	Delberz	false
regions_battle_name_wh3_main_chaos_region_dharko_wharf	Dharko Wharf	false
regions_battle_name_wh3_main_chaos_region_dhazhyn	Dhazhyn	false
regions_battle_name_wh3_main_chaos_region_dietershafen	Dietershafen	false
regions_battle_name_wh3_main_chaos_region_doomkeep	Doomkeep	false
regions_battle_name_wh3_main_chaos_region_dragon_fang_mount	Dragon Fang Mount	false
regions_battle_name_wh3_main_chaos_region_dragon_gate	Dragon Gate	false
regions_battle_name_wh3_main_chaos_region_dragon_river	Dragon River	false
regions_battle_name_wh3_main_chaos_region_dragons_crossroad	Dragon's Crossroad	false
regions_battle_name_wh3_main_chaos_region_dragons_death	Dragon's Death	false
regions_battle_name_wh3_main_chaos_region_dushyka	Dushyka	false
regions_battle_name_wh3_main_chaos_region_eagle_eyries	Eagle Eyries	false
regions_battle_name_wh3_main_chaos_region_eilhart	Eilhart	false
regions_battle_name_wh3_main_chaos_region_erengrad	Erengrad	false
regions_battle_name_wh3_main_chaos_region_fallen_city	Fallen City	false
regions_battle_name_wh3_main_chaos_region_fire_mouth	Fire Mouth	false
regions_battle_name_wh3_main_chaos_region_floating_mountain	Floating Mountain	false
regions_battle_name_wh3_main_chaos_region_fort_bergbres	Fort Bergbres	false
regions_battle_name_wh3_main_chaos_region_fort_dolganyeir	Fort Dolganyeir	false
regions_battle_name_wh3_main_chaos_region_fort_dorznye_vort	Fort Dorznye-Vort	false
regions_battle_name_wh3_main_chaos_region_fort_jakova	Fort Jakova	false
regions_battle_name_wh3_main_chaos_region_fort_ostrosk	Fort Ostrosk	false
regions_battle_name_wh3_main_chaos_region_fort_straghov	Lair of the Troll King	false
regions_battle_name_wh3_main_chaos_region_fortenhof	Fortenhof	false
regions_battle_name_wh3_main_chaos_region_fortress_of_eyes	Fortress of Eyes	false
regions_battle_name_wh3_main_chaos_region_fortress_of_the_damned	Fortress of the Damned	false
regions_battle_name_wh3_main_chaos_region_foul_fortress	Foul Fortress	false
regions_battle_name_wh3_main_chaos_region_foundry_of_bones	Foundry of Bones	false
regions_battle_name_wh3_main_chaos_region_frozen_landing	Frozen Landing	false
regions_battle_name_wh3_main_chaos_region_frozen_sea	Frozen Sea	false
regions_battle_name_wh3_main_chaos_region_gerslev	Gerslev	false
regions_battle_name_wh3_main_chaos_region_glut_port	Glut-Port	false
regions_battle_name_wh3_main_chaos_region_gnashraks_lair	Gnashrak's Lair	false
regions_battle_name_wh3_main_chaos_region_gorger_rock	Gorger Rock	false
regions_battle_name_wh3_main_chaos_region_gorssel	Gorssel	false
regions_battle_name_wh3_main_chaos_region_graeling_moot	Graeling Moot	false
regions_battle_name_wh3_main_chaos_region_granite_spikes	Granite Spikes	false
regions_battle_name_wh3_main_chaos_region_great_hall_of_greasus	Great Hall of Greasus	false
regions_battle_name_wh3_main_chaos_region_great_river	Great River	false
regions_battle_name_wh3_main_chaos_region_grim_duraz	Grim Duraz	false
regions_battle_name_wh3_main_chaos_region_grimtop	Grimtop	false
regions_battle_name_wh3_main_chaos_region_grissenwald	Grissenwald	false
regions_battle_name_wh3_main_chaos_region_gristle_valley	Gristle Valley	false
regions_battle_name_wh3_main_chaos_region_hanyu_port	Hanyu Port	false
regions_battle_name_wh3_main_chaos_region_hell_pit	Hell Pit	false
regions_battle_name_wh3_main_chaos_region_hellcade_drove	Hellcade Drove	false
regions_battle_name_wh3_main_chaos_region_hergig	Hergig	false
regions_battle_name_wh3_main_chaos_region_hissing_pits	Hissing Pits	false
regions_battle_name_wh3_main_chaos_region_howling_rock	Howling Rock	false
regions_battle_name_wh3_main_chaos_region_ice_caverns_of_ymirdrak	Ice Caverns of Ymirdrak	false
regions_battle_name_wh3_main_chaos_region_icedrake_fjord	Icedrake Fjord	false
regions_battle_name_wh3_main_chaos_region_icespewer	Icespewer	false
regions_battle_name_wh3_main_chaos_region_igerov	Igerov	false
regions_battle_name_wh3_main_chaos_region_infernius	Infernius	false
regions_battle_name_wh3_main_chaos_region_iron_storm	Iron Storm	false
regions_battle_name_wh3_main_chaos_region_jade_river	Jade River	false
regions_battle_name_wh3_main_chaos_region_jade_wind_mountain	Jade Wind Mountain	false
regions_battle_name_wh3_main_chaos_region_karak_azgaraz	Karak Azgaraz	false
regions_battle_name_wh3_main_chaos_region_karak_azorn	Karak Azorn	false
regions_battle_name_wh3_main_chaos_region_karak_dum	Karak Dum	false
regions_battle_name_wh3_main_chaos_region_karak_kadrin	Karak Kadrin	false
regions_battle_name_wh3_main_chaos_region_karak_krakaten	Karak Krakaten	false
regions_battle_name_wh3_main_chaos_region_karak_raziak	Karak Raziak	false
regions_battle_name_wh3_main_chaos_region_karak_ungor	Karak Ungor	false
regions_battle_name_wh3_main_chaos_region_karak_vlag	Karak Vlag	false
regions_battle_name_wh3_main_chaos_region_karak_vrag	Karak Vrag	false
regions_battle_name_wh3_main_chaos_region_karak_ziflin	Karak Ziflin	false
regions_battle_name_wh3_main_chaos_region_khazid_irkulaz	Khazid Irkulaz	false
regions_battle_name_wh3_main_chaos_region_kislev	Kislev	false
regions_battle_name_wh3_main_chaos_region_konigstein_tower	Konigstein Tower	false
regions_battle_name_wh3_main_chaos_region_kraka_dorden	Kraka Dorden	false
regions_battle_name_wh3_main_chaos_region_kraka_drak	Kraka Drak	false
regions_battle_name_wh3_main_chaos_region_kraken_sea	Kraken Sea	false
regions_battle_name_wh3_main_chaos_region_kraz_und	Kraz Und	false
regions_battle_name_wh3_main_chaos_region_krudenwald	Krudenwald	false
regions_battle_name_wh3_main_chaos_region_kunlan	Kunlan	false
regions_battle_name_wh3_main_chaos_region_kurak_peak	Kurak Peak	false
regions_battle_name_wh3_main_chaos_region_kusel	KÃ¼sel	false
regions_battle_name_wh3_main_chaos_region_land_of_the_plaguelord	Land of the Plaguelord	false
regions_battle_name_wh3_main_chaos_region_laurelorn_forest	Laurelorn Forest	false
regions_battle_name_wh3_main_chaos_region_leblya	Leblya	false
regions_battle_name_wh3_main_chaos_region_longship_graveyard	Longship Graveyard	false
regions_battle_name_wh3_main_chaos_region_marienburg	Marienburg	false
regions_battle_name_wh3_main_chaos_region_middenheim	Middenheim	false
regions_battle_name_wh3_main_chaos_region_mines_of_gorgoth	Mines of Gorgoth	false
regions_battle_name_wh3_main_chaos_region_mines_of_nan_yang	Mines of Nan-Yang	false
regions_battle_name_wh3_main_chaos_region_ming_zhu	Ming Zhu	false
regions_battle_name_wh3_main_chaos_region_mist_gorge	Mist Gorge	false
regions_battle_name_wh3_main_chaos_region_mount_cragg	Mount Cragg	false
regions_battle_name_wh3_main_chaos_region_mount_grey_hag	Mount Grey Hag	false
regions_battle_name_wh3_main_chaos_region_mount_grimfang	Mount Grimfang	false
regions_battle_name_wh3_main_chaos_region_mount_gunbad	Mount Gunbad	false
regions_battle_name_wh3_main_chaos_region_mount_thug	Mount Thug	false
regions_battle_name_wh3_main_chaos_region_nan_gau	Nan-Gau	false
regions_battle_name_wh3_main_chaos_region_nan_li	Nan-Li	false
regions_battle_name_wh3_main_chaos_region_nonchang	Nongchang	false
regions_battle_name_wh3_main_chaos_region_norden	Norden	false
regions_battle_name_wh3_main_chaos_region_novchozy	Novchozy	false
regions_battle_name_wh3_main_chaos_region_nuln	Nuln	false
regions_battle_name_wh3_main_chaos_region_oakenhammer	Oakenhammer	false
regions_battle_name_wh3_main_chaos_region_osterwald	Osterwald	false
regions_battle_name_wh3_main_chaos_region_pack_ice_bay	Pack Ice Bay	false
regions_battle_name_wh3_main_chaos_region_palace_of_princes	Palace of Princes	false
regions_battle_name_wh3_main_chaos_region_pigbarter	Pigbarter	false
regions_battle_name_wh3_main_chaos_region_pillar_of_skulls	Pillar of Skulls	false
regions_battle_name_wh3_main_chaos_region_plesk	Plesk	false
regions_battle_name_wh3_main_chaos_region_po_mei	Po Mei	false
regions_battle_name_wh3_main_chaos_region_praag	Praag	false
regions_battle_name_wh3_main_chaos_region_qiang	Qiang	false
regions_battle_name_wh3_main_chaos_region_realm_of_chaos	The Realm of Chaos	false
regions_battle_name_wh3_main_chaos_region_realm_of_the_sorcerer_1	Realm of the Sorcerer	false
regions_battle_name_wh3_main_chaos_region_realm_of_the_sorcerer_2	Realm of the Sorcerer	false
regions_battle_name_wh3_main_chaos_region_realm_of_the_sorcerer_3	Realm of the Sorcerer	false
regions_battle_name_wh3_main_chaos_region_realm_of_the_sorcerer_4	Realm of the Sorcerer	false
regions_battle_name_wh3_main_chaos_region_realm_of_the_sorcerer_5	Realm of the Sorcerer	false
regions_battle_name_wh3_main_chaos_region_realm_of_the_sorcerer_6	Realm of the Sorcerer	false
regions_battle_name_wh3_main_chaos_region_realm_of_the_sorcerer_7	Realm of the Sorcerer	false
regions_battle_name_wh3_main_chaos_region_red_fortress	Red Fortress	false
regions_battle_name_wh3_main_chaos_region_rosche	Rosche	false
regions_battle_name_wh3_main_chaos_region_sabre_mountain	Sabre Mountain	false
regions_battle_name_wh3_main_chaos_region_salzenmund	Salzenmund	false
regions_battle_name_wh3_main_chaos_region_sea_of_chaos	Sea of Chaos	false
regions_battle_name_wh3_main_chaos_region_sea_of_claws	Sea of Claws	false
regions_battle_name_wh3_main_chaos_region_seep_gore	Seep-Gore	false
regions_battle_name_wh3_main_chaos_region_sepukzy	Sepukzy	false
regions_battle_name_wh3_main_chaos_region_serpent_jetty	Serpent Jetty	false
regions_battle_name_wh3_main_chaos_region_shambletown	Shambletown	false
regions_battle_name_wh3_main_chaos_region_shang_wu	Shang-Wu	false
regions_battle_name_wh3_main_chaos_region_shang_yang	Shang-Yang	false
regions_battle_name_wh3_main_chaos_region_shattered_stone_bay	Shattered Stone Bay	false
regions_battle_name_wh3_main_chaos_region_shi_long	Shi Long	false
regions_battle_name_wh3_main_chaos_region_shrine_of_the_alchemist	Shrine of the Alchemist	false
regions_battle_name_wh3_main_chaos_region_siegfriedhof	Siegfriedhof	false
regions_battle_name_wh3_main_chaos_region_sjoktraken	Sjoktraken	false
regions_battle_name_wh3_main_chaos_region_skrap_towers	Skrap Towers	false
regions_battle_name_wh3_main_chaos_region_slaanesh_fifth	The Circle of Vainglory	false
regions_battle_name_wh3_main_chaos_region_slaanesh_first	The Circle of Avidity	false
regions_battle_name_wh3_main_chaos_region_slaanesh_fourth	The Circle of Paramountcy	false
regions_battle_name_wh3_main_chaos_region_slaanesh_second	The Circle of Gluttony	false
regions_battle_name_wh3_main_chaos_region_slaanesh_sixth	The Circle of Indolency	false
regions_battle_name_wh3_main_chaos_region_slaanesh_start_01	The Dark Prince's Realm	false
regions_battle_name_wh3_main_chaos_region_slaanesh_start_02	The Dark Prince's Realm	false
regions_battle_name_wh3_main_chaos_region_slaanesh_start_03	The Dark Prince's Realm	false
regions_battle_name_wh3_main_chaos_region_slaanesh_start_04	The Dark Prince's Realm	false
regions_battle_name_wh3_main_chaos_region_slaanesh_start_05	The Dark Prince's Realm	false
regions_battle_name_wh3_main_chaos_region_slaanesh_start_06	The Dark Prince's Realm	false
regions_battle_name_wh3_main_chaos_region_slaanesh_start_07	The Dark Prince's Realm	false
regions_battle_name_wh3_main_chaos_region_slaanesh_start_08	The Dark Prince's Realm	false
regions_battle_name_wh3_main_chaos_region_slaanesh_third	The Circle of Carnality	false
regions_battle_name_wh3_main_chaos_region_snake_gate	Snake Gate	false
regions_battle_name_wh3_main_chaos_region_stormvrack_mount	Stormvrack Mount	false
regions_battle_name_wh3_main_chaos_region_tai_tzu	Tai Tzu	false
regions_battle_name_wh3_main_chaos_region_talabheim	Talabheim	false
regions_battle_name_wh3_main_chaos_region_temple_of_elemental_winds	Temple of Elemental Winds	false
regions_battle_name_wh3_main_chaos_region_temple_of_heimkel	Temple of Heimkel	false
regions_battle_name_wh3_main_chaos_region_terracotta_graveyard	Terracotta Graveyard	false
regions_battle_name_wh3_main_chaos_region_the_bleeding_spire	The Bleeding Spire	false
regions_battle_name_wh3_main_chaos_region_the_blighted_grove	The Blighted Grove	false
regions_battle_name_wh3_main_chaos_region_the_blood_gods_domain	The Blood God's Domain	false
regions_battle_name_wh3_main_chaos_region_the_brass_glacier	The Brass Glacier	false
regions_battle_name_wh3_main_chaos_region_the_burning_monolith	The Burning Monolith	false
regions_battle_name_wh3_main_chaos_region_the_challenge_stone	The Challenge Stone	false
regions_battle_name_wh3_main_chaos_region_the_crystal_spires	The Crystal Spires	false
regions_battle_name_wh3_main_chaos_region_the_daemons_stump	The Daemon's Stump	false
regions_battle_name_wh3_main_chaos_region_the_dark_princes_realm	The Dark Prince's Realm	false
regions_battle_name_wh3_main_chaos_region_the_falls_of_doom	The Falls of Doom	false
regions_battle_name_wh3_main_chaos_region_the_fetid_catacombs	The Fetid Catacombs	false
regions_battle_name_wh3_main_chaos_region_the_folly_of_malofex	The Folly of Malofex	false
regions_battle_name_wh3_main_chaos_region_the_forbidden_citadel	The Forbidden Citadel	false
regions_battle_name_wh3_main_chaos_region_the_forest_of_decay	The Forest of Decay	false
regions_battle_name_wh3_main_chaos_region_the_forge_of_souls	The Forge of Souls	false
regions_battle_name_wh3_main_chaos_region_the_fortress_of_vorag	The Fortress of Vorag	false
regions_battle_name_wh3_main_chaos_region_the_gallows_tree	The Gallows Tree	false
regions_battle_name_wh3_main_chaos_region_the_gates_of_zharr	The Gates of Zharr	false
regions_battle_name_wh3_main_chaos_region_the_gulf_of_kislev	The Gulf of Kislev	false
regions_battle_name_wh3_main_chaos_region_the_last_sky_castle	The Last Sky Castle	false
regions_battle_name_wh3_main_chaos_region_the_monolith_of_katam	The Monolith of Katam	false
regions_battle_name_wh3_main_chaos_region_the_monolith_of_kjarl_deathaxe	Deathaxe's Monolith	false
regions_battle_name_wh3_main_chaos_region_the_monolith_of_the_void	The Monolith of the Void	false
regions_battle_name_wh3_main_chaos_region_the_palace_of_ruin	The Palace of Ruin	false
regions_battle_name_wh3_main_chaos_region_the_red_abyss	The Red Abyss	false
regions_battle_name_wh3_main_chaos_region_the_sea_of_dread	The Sea of Dread	false
regions_battle_name_wh3_main_chaos_region_the_sentinels	The Sentinels	false
regions_battle_name_wh3_main_chaos_region_the_shifting_monolith	The Shifting Monolith	false
regions_battle_name_wh3_main_chaos_region_the_silver_pinnacle	The Silver Pinnacle	false
regions_battle_name_wh3_main_chaos_region_the_silvered_tower_of_sorcerers	The Silvered Tower of Sorcerers	false
regions_battle_name_wh3_main_chaos_region_the_sky_monolith	The Sky Monolith	false
regions_battle_name_wh3_main_chaos_region_the_sunken_sewers	The Sunken Sewers	false
regions_battle_name_wh3_main_chaos_region_the_tower_of_flies	The Tower of Flies	false
regions_battle_name_wh3_main_chaos_region_the_tower_of_gorgoth	The Tower of Gorgoth	false
regions_battle_name_wh3_main_chaos_region_the_tower_of_khrakk	The Tower of Khrakk	false
regions_battle_name_wh3_main_chaos_region_the_tower_of_torment	The Tower of Torment	false
regions_battle_name_wh3_main_chaos_region_the_twisted_towers	The Twisted Towers	false
regions_battle_name_wh3_main_chaos_region_the_vale_of_nightmares	The Vale of Nightmares	false
regions_battle_name_wh3_main_chaos_region_the_volary	The Volary	false
regions_battle_name_wh3_main_chaos_region_the_writhing_fortress	The Writhing Fortress	false
regions_battle_name_wh3_main_chaos_region_titans_notch	Titan's Notch	false
regions_battle_name_wh3_main_chaos_region_tower_of_ashshair	Tower of Ashshair	false
regions_battle_name_wh3_main_chaos_region_tower_of_grief	Tower of Grief	false
regions_battle_name_wh3_main_chaos_region_tree_of_damned_shades	Tree of Damned Shades	false
regions_battle_name_wh3_main_chaos_region_troll_fjord	Troll Fjord	false
regions_battle_name_wh3_main_chaos_region_turtle_gate	Turtle Gate	false
regions_battle_name_wh3_main_chaos_region_ubersreik	Ubersreik	false
regions_battle_name_wh3_main_chaos_region_uzkulak	Uzkulak	false
regions_battle_name_wh3_main_chaos_region_uzkulany	Uzkulany	false
regions_battle_name_wh3_main_chaos_region_vale_of_titans	Vale of Titans	false
regions_battle_name_wh3_main_chaos_region_village_of_the_moon	Village of the Moon	false
regions_battle_name_wh3_main_chaos_region_village_of_the_tigermen	Village of the Tigermen	false
regions_battle_name_wh3_main_chaos_region_volcanos_heart	Volcano's Heart	false
regions_battle_name_wh3_main_chaos_region_volksgrad	Volksgrad	false
regions_battle_name_wh3_main_chaos_region_waldenhof	Waldenhof	false
regions_battle_name_wh3_main_chaos_region_wei_jin	Wei-Jin	false
regions_battle_name_wh3_main_chaos_region_weng_chang	Weng Chang	false
regions_battle_name_wh3_main_chaos_region_winter_pyre	Winter Pyre	false
regions_battle_name_wh3_main_chaos_region_wolfenburg	Wolfenburg	false
regions_battle_name_wh3_main_chaos_region_wurtbad	Wurtbad	false
regions_battle_name_wh3_main_chaos_region_wurzen	Wurzen	false
regions_battle_name_wh3_main_chaos_region_xen_wu	Xen Wu	false
regions_battle_name_wh3_main_chaos_region_xing_po	Xing Po	false
regions_battle_name_wh3_main_chaos_region_yetchitch	Yetchitch	false
regions_battle_name_wh3_main_chaos_region_yhetee_peak	Yhetee Peak	false
regions_battle_name_wh3_main_chaos_region_zamoski	Zamoski	false
regions_battle_name_wh3_main_chaos_region_zanbaijin	Plains of Zanbaijin	false
regions_battle_name_wh3_main_chaos_region_zerulous	Zerulous	false
regions_battle_name_wh3_main_chaos_region_zhanshi	Zhanshi	false
regions_battle_name_wh3_main_chaos_region_zharr_naggrund	Zharr Naggrund	false
regions_battle_name_wh3_main_chaos_region_zhufbar	Zhufbar	false
regions_battle_name_wh3_main_chaos_region_zoishenk	Zoishenk	false
regions_battle_name_wh3_main_combi_region_aarnau	Aarnau	false
regions_battle_name_wh3_main_combi_region_agrul_migdhal	Agrul Migdhal	false
regions_battle_name_wh3_main_combi_region_akendorf	Akendorf	false
regions_battle_name_wh3_main_combi_region_al_haikk	Al Haikk	false
regions_battle_name_wh3_main_combi_region_altar_of_facades	Altar of Facades	false
regions_battle_name_wh3_main_combi_region_altar_of_spawns	Altar of Spawns	false
regions_battle_name_wh3_main_combi_region_altar_of_the_crimson_harvest	Altar of the Crimson Harvest	false
regions_battle_name_wh3_main_combi_region_altar_of_the_horned_rat	Altar of the Horned Rat	false
regions_battle_name_wh3_main_combi_region_altar_of_ultimate_darkness	Altar of Ultimate Darkness	false
regions_battle_name_wh3_main_combi_region_altdorf	Altdorf	false
regions_battle_name_wh3_main_combi_region_amblepeak	Amblepeak	false
regions_battle_name_wh3_main_combi_region_ancient_city_of_quintex	Ancient City of Quintex	false
regions_battle_name_wh3_main_combi_region_angerrial	Angerrial	false
regions_battle_name_wh3_main_combi_region_antoch	Antoch	false
regions_battle_name_wh3_main_combi_region_aquitaine	Aquitaine	false
regions_battle_name_wh3_main_combi_region_argalis	Argalis	false
regions_battle_name_wh3_main_combi_region_arnheim	Arnheim	false
regions_battle_name_wh3_main_combi_region_ash_ridge_mountains	Ash Ridge Mountains	false
regions_battle_name_wh3_main_combi_region_ashrak	Ashrak	false
regions_battle_name_wh3_main_combi_region_averheim	Averheim	false
regions_battle_name_wh3_main_combi_region_avethir	Avethir	false
regions_battle_name_wh3_main_combi_region_axlotl	Axlotl	false
regions_battle_name_wh3_main_combi_region_baleful_hills	Baleful Hills	false
regions_battle_name_wh3_main_combi_region_bamboo_crossing	Bamboo Crossing	false
regions_battle_name_wh3_main_combi_region_barag_dawazbag	Barag Dawazbag	false
regions_battle_name_wh3_main_combi_region_barak_varr	Barak Varr	false
regions_battle_name_wh3_main_combi_region_bay_of_blades	Bay of Blades	false
regions_battle_name_wh3_main_combi_region_bechafen	Bechafen	false
regions_battle_name_wh3_main_combi_region_beichai	Beichai	false
regions_battle_name_wh3_main_combi_region_bhagar	Bhagar	false
regions_battle_name_wh3_main_combi_region_bilbali	Bilbali	false
regions_battle_name_wh3_main_combi_region_bilious_cliffs	Bilious Cliffs	false
regions_battle_name_wh3_main_combi_region_bitter_bay	Bitter Bay	false
regions_battle_name_wh3_main_combi_region_bitterstone_mine	Bitterstone Mine	false
regions_battle_name_wh3_main_combi_region_black_crag	Black Crag	false
regions_battle_name_wh3_main_combi_region_black_creek_spire	Black Creek Spire	false
regions_battle_name_wh3_main_combi_region_black_fang	Black Fang	false
regions_battle_name_wh3_main_combi_region_black_fortress	Black Fortress	false
regions_battle_name_wh3_main_combi_region_black_iron_mine	Black Iron Mine	false
regions_battle_name_wh3_main_combi_region_black_pyramid_of_nagash	Black Pyramid of Nagash	false
regions_battle_name_wh3_main_combi_region_black_rock	Black Rock	false
regions_battle_name_wh3_main_combi_region_black_tower_of_arkhan	Black Tower of Arkhan	false
regions_battle_name_wh3_main_combi_region_blacklight_tower	Blacklight Tower	false
regions_battle_name_wh3_main_combi_region_blackstone_post	Blackstone Post	false
regions_battle_name_wh3_main_combi_region_bleak_hold_fortress	Bleak Hold Fortress	false
regions_battle_name_wh3_main_combi_region_blizzardpeak	Blizzardpeak	false
regions_battle_name_wh3_main_combi_region_blood_mountain	Blood Mountain	false
regions_battle_name_wh3_main_combi_region_bloodpeak	Bloodpeak	false
regions_battle_name_wh3_main_combi_region_bloodwind_keep	Bloodwind Keep	false
regions_battle_name_wh3_main_combi_region_blue_river	Blue River	false
regions_battle_name_wh3_main_combi_region_bordeleaux	Bordeleaux	false
regions_battle_name_wh3_main_combi_region_brass_keep	Brass Keep	false
regions_battle_name_wh3_main_combi_region_bridge_of_heaven	Bridge of Heaven	false
regions_battle_name_wh3_main_combi_region_brionne	Brionne	false
regions_battle_name_wh3_main_combi_region_cairn_thel	Cairn Thel	false
regions_battle_name_wh3_main_combi_region_carroburg	Carroburg	false
regions_battle_name_wh3_main_combi_region_castle_alexandronov	Castle Alexandronov	false
regions_battle_name_wh3_main_combi_region_castle_artois	Castle Artois	false
regions_battle_name_wh3_main_combi_region_castle_bastonne	Castle Bastonne	false
regions_battle_name_wh3_main_combi_region_castle_carcassonne	Castle Carcassonne	false
regions_battle_name_wh3_main_combi_region_castle_drakenhof	Castle Drakenhof	false
regions_battle_name_wh3_main_combi_region_castle_of_splendour	Castle of Splendour	false
regions_battle_name_wh3_main_combi_region_castle_templehof	Castle Templehof	false
regions_battle_name_wh3_main_combi_region_castle_von_rauken	Castle von Rauken	false
regions_battle_name_wh3_main_combi_region_caverns_of_sotek	Caverns of Sotek	false
regions_battle_name_wh3_main_combi_region_celestial_lake	Celestial Lake	false
regions_battle_name_wh3_main_combi_region_celestial_monastery	Celestial Monastery	false
regions_battle_name_wh3_main_combi_region_chamber_of_visions	Chamber of Visions	false
regions_battle_name_wh3_main_combi_region_chaos_wasteland	Chaos Wasteland	false
regions_battle_name_wh3_main_combi_region_chaqua	Chaqua	false
regions_battle_name_wh3_main_combi_region_chill_road	The Chill Road	false
regions_battle_name_wh3_main_combi_region_chimai	Chimai	false
regions_battle_name_wh3_main_combi_region_chupayotl	Chupayotl	false
regions_battle_name_wh3_main_combi_region_circle_of_destruction	Circle of Destruction	false
regions_battle_name_wh3_main_combi_region_citadel_of_dusk	Citadel of Dusk	false
regions_battle_name_wh3_main_combi_region_citadel_of_lead	Citadel of Lead	false
regions_battle_name_wh3_main_combi_region_city_of_the_shugengan	City of the Shugengan	false
regions_battle_name_wh3_main_combi_region_clar_karond	Clar Karond	false
regions_battle_name_wh3_main_combi_region_clarak_spire	Clarak Spire	false
regions_battle_name_wh3_main_combi_region_cliff_of_beasts	Cliff of Beasts	false
regions_battle_name_wh3_main_combi_region_copher	Copher	false
regions_battle_name_wh3_main_combi_region_couronne	Couronne	false
regions_battle_name_wh3_main_combi_region_crag_halls_of_findol	Crag Halls of Findol	false
regions_battle_name_wh3_main_combi_region_cragroth_deep	Cragroth Deep	false
regions_battle_name_wh3_main_combi_region_crookback_mountain	Crookback Mountain	false
regions_battle_name_wh3_main_combi_region_crooked_fang_fort	Crooked Fang Fort	false
regions_battle_name_wh3_main_combi_region_crucible_of_delights	Crucible of Delights	false
regions_battle_name_wh3_main_combi_region_cuexotl	Cuexotl	false
regions_battle_name_wh3_main_combi_region_daemons_gate	Daemon's Gate	false
regions_battle_name_wh3_main_combi_region_daemons_landing	Daemon's Landing	false
regions_battle_name_wh3_main_combi_region_dagraks_end	Dagrak's End	false
regions_battle_name_wh3_main_combi_region_dai_cheng	Dai Cheng	false
regions_battle_name_wh3_main_combi_region_dargoth	Dargoth	false
regions_battle_name_wh3_main_combi_region_darkhold	Darkhold	false
regions_battle_name_wh3_main_combi_region_dawns_light	Dawn's Light	false
regions_battle_name_wh3_main_combi_region_deaths_head_monoliths	Dead-Head Monoliths	false
regions_battle_name_wh3_main_combi_region_deff_gorge	Deff Gorge	false
regions_battle_name_wh3_main_combi_region_desolation_of_drakenmoor	Desolation of Drakenmoor	false
regions_battle_name_wh3_main_combi_region_desolation_of_nagash	Desolation of Nagash	false
regions_battle_name_wh3_main_combi_region_dietershafen	Dietershafen	false
regions_battle_name_wh3_main_combi_region_dok_karaz	Dok Karaz	false
regions_battle_name_wh3_main_combi_region_doom_glade	Doom Glade	false
regions_battle_name_wh3_main_combi_region_doomkeep	Doomkeep	false
regions_battle_name_wh3_main_combi_region_dotternbach	Dotternbach	false
regions_battle_name_wh3_main_combi_region_drackla_spire	Drackla Spire	false
regions_battle_name_wh3_main_combi_region_dragon_fang_mount	Dragon Fang Mount	false
regions_battle_name_wh3_main_combi_region_dragon_gate	Dragon Gate	false
regions_battle_name_wh3_main_combi_region_dragonhorn_mines	Dragonhorn Mines	false
regions_battle_name_wh3_main_combi_region_dragons_crossroad	Dragon's Crossroad	false
regions_battle_name_wh3_main_combi_region_dread_rock	Dread Rock	false
regions_battle_name_wh3_main_combi_region_dringorackaz	Dringorackaz	false
regions_battle_name_wh3_main_combi_region_dusk_peaks	Dusk Peaks	false
regions_battle_name_wh3_main_combi_region_eagle_eyries	Eagle Eyries	false
regions_battle_name_wh3_main_combi_region_eagle_gate	Eagle Gate	false
regions_battle_name_wh3_main_combi_region_eastern_sea_of_dread	Eastern Sea of Dread	false
regions_battle_name_wh3_main_combi_region_eilhart	Eilhart	false
regions_battle_name_wh3_main_combi_region_ekrund	Ekrund	false
regions_battle_name_wh3_main_combi_region_el_kalabad	El-Kalabad	false
regions_battle_name_wh3_main_combi_region_eldar_spire	Eldar Spire	false
regions_battle_name_wh3_main_combi_region_elessaeli	Elessaeli	false
regions_battle_name_wh3_main_combi_region_elisia	Elisia	false
regions_battle_name_wh3_main_combi_region_erengrad	Erengrad	false
regions_battle_name_wh3_main_combi_region_eschen	Eschen	false
regions_battle_name_wh3_main_combi_region_essen	Essen	false
regions_battle_name_wh3_main_combi_region_evershale	Evershale	false
regions_battle_name_wh3_main_combi_region_eye_of_the_panther	Eye of the Panther	false
regions_battle_name_wh3_main_combi_region_fallen_gates	Fallen Gates	false
regions_battle_name_wh3_main_combi_region_fallen_king_mountain	Fallen King Mountain	false
regions_battle_name_wh3_main_combi_region_fateweavers_crevasse	Fateweaver's Crevasse	false
regions_battle_name_wh3_main_combi_region_fire_mouth	Fire Mouth	false
regions_battle_name_wh3_main_combi_region_flayed_rock	Flayed Rock	false
regions_battle_name_wh3_main_combi_region_flensburg	Flensburg	false
regions_battle_name_wh3_main_combi_region_floating_mountain	Floating Mountain	false
regions_battle_name_wh3_main_combi_region_floating_pyramid	Floating Pyramid	false
regions_battle_name_wh3_main_combi_region_floating_village	Floating Village	false
regions_battle_name_wh3_main_combi_region_forest_of_arnheim	Forest of Arnheim	false
regions_battle_name_wh3_main_combi_region_forest_of_gloom	Forest of Gloom	false
regions_battle_name_wh3_main_combi_region_fort_bergbres	Fort Bergbres	false
regions_battle_name_wh3_main_combi_region_fort_jakova	Fort Jakova	false
regions_battle_name_wh3_main_combi_region_fort_oberstyre	Fort Oberstyre	false
regions_battle_name_wh3_main_combi_region_fort_ostrosk	Fort Ostrosk	false
regions_battle_name_wh3_main_combi_region_fort_soll	Fort Soll	false
regions_battle_name_wh3_main_combi_region_fort_straghov	Fort Straghov	false
regions_battle_name_wh3_main_combi_region_fortress_of_dawn	Fortress of Dawn	false
regions_battle_name_wh3_main_combi_region_fortress_of_eyes	Fortress of Eyes	false
regions_battle_name_wh3_main_combi_region_fortress_of_the_damned	Fortress of the Damned	false
regions_battle_name_wh3_main_combi_region_foundry_of_bones	Foundry of Bones	false
regions_battle_name_wh3_main_combi_region_frozen_landing	Frozen Landing	false
regions_battle_name_wh3_main_combi_region_frozen_sea	Frozen Sea	false
regions_battle_name_wh3_main_combi_region_fu_chow	Fu-Chow	false
regions_battle_name_wh3_main_combi_region_fu_hung	Fu Hung	false
regions_battle_name_wh3_main_combi_region_fuming_serpent	Fuming Serpent	false
regions_battle_name_wh3_main_combi_region_fyrus	Fyrus	false
regions_battle_name_wh3_main_combi_region_gaean_vale	Gaean Vale	false
regions_battle_name_wh3_main_combi_region_galbaraz	Galbaraz	false
regions_battle_name_wh3_main_combi_region_ghrond	Ghrond	false
regions_battle_name_wh3_main_combi_region_gisoreux	Gisoreux	false
regions_battle_name_wh3_main_combi_region_gnashraks_lair	Gnashrak's Lair	false
regions_battle_name_wh3_main_combi_region_gnobbly_gorge	Gnobbly Gorge	false
regions_battle_name_wh3_main_combi_region_golden_ziggurat	Golden Ziggurat	false
regions_battle_name_wh3_main_combi_region_gor_gazan	Gor Gazan	false
regions_battle_name_wh3_main_combi_region_gorger_rock	Gorger Rock	false
regions_battle_name_wh3_main_combi_region_gorssel	Gorssel	false
regions_battle_name_wh3_main_combi_region_graeling_moot	Graeling Moot	false
regions_battle_name_wh3_main_combi_region_granite_massif	Granite Massif	false
regions_battle_name_wh3_main_combi_region_granite_spikes	Granite Spikes	false
regions_battle_name_wh3_main_combi_region_great_canal	Great Canal	false
regions_battle_name_wh3_main_combi_region_great_desert_of_araby	Great Desert of Araby	false
regions_battle_name_wh3_main_combi_region_great_hall_of_greasus	Great Hall of Greasus	false
regions_battle_name_wh3_main_combi_region_great_river	Great River	false
regions_battle_name_wh3_main_combi_region_great_skull_lakes	Great Skull Lakes	false
regions_battle_name_wh3_main_combi_region_great_turtle_isle	Great Turtle Isle	false
regions_battle_name_wh3_main_combi_region_grenzstadt	Grenzstadt	false
regions_battle_name_wh3_main_combi_region_grey_rock_point	Grey Rock Point	false
regions_battle_name_wh3_main_combi_region_griffon_gate	Griffon Gate	false
regions_battle_name_wh3_main_combi_region_grimhold	Grimhold	false
regions_battle_name_wh3_main_combi_region_grimtop	Grimtop	false
regions_battle_name_wh3_main_combi_region_gristle_valley	Gristle Valley	false
regions_battle_name_wh3_main_combi_region_grom_peak	Grom Peak	false
regions_battle_name_wh3_main_combi_region_gronti_mingol	Gronti Mingol	false
regions_battle_name_wh3_main_combi_region_grotrilexs_glare_lighthouse	Grotrilex's Glare Lighthouse	false
regions_battle_name_wh3_main_combi_region_grunburg	Grunburg	false
regions_battle_name_wh3_main_combi_region_grung_zint	Grung Zint	false
regions_battle_name_wh3_main_combi_region_gryphon_wood	Gryphon Wood	false
regions_battle_name_wh3_main_combi_region_gulf_of_kislev	Gulf of Kislev	false
regions_battle_name_wh3_main_combi_region_gulf_of_medes	Gulf of Medes	false
regions_battle_name_wh3_main_combi_region_hag_graef	Hag Graef	false
regions_battle_name_wh3_main_combi_region_hag_hall	Hag Hall	false
regions_battle_name_wh3_main_combi_region_haichai	Haichai	false
regions_battle_name_wh3_main_combi_region_hanyu_port	Hanyu Port	false
regions_battle_name_wh3_main_combi_region_har_ganeth	Har Ganeth	false
regions_battle_name_wh3_main_combi_region_har_kaldra	Har Kaldra	false
regions_battle_name_wh3_main_combi_region_hell_pit	Hell Pit	false
regions_battle_name_wh3_main_combi_region_helmgart	Helmgart	false
regions_battle_name_wh3_main_combi_region_hergig	Hergig	false
regions_battle_name_wh3_main_combi_region_hexoatl	Hexoatl	false
regions_battle_name_wh3_main_combi_region_hoteks_column	Hotek's Column	false
regions_battle_name_wh3_main_combi_region_howling_rock	Howling Rock	false
regions_battle_name_wh3_main_combi_region_hualotal	Hualotal	false
regions_battle_name_wh3_main_combi_region_ice_rock_gorge	Ice Rock Gorge	false
regions_battle_name_wh3_main_combi_region_icespewer	Icespewer	false
regions_battle_name_wh3_main_combi_region_infernius	Infernius	false
regions_battle_name_wh3_main_combi_region_iron_rock	Iron Rock	false
regions_battle_name_wh3_main_combi_region_iron_storm	Iron Storm	false
regions_battle_name_wh3_main_combi_region_ironfrost	Ironfrost	false
regions_battle_name_wh3_main_combi_region_ironspike	Ironspike	false
regions_battle_name_wh3_main_combi_region_isle_of_wights	Isle of Wights	false
regions_battle_name_wh3_main_combi_region_itza	Itza	false
regions_battle_name_wh3_main_combi_region_jade_river	Jade River	false
regions_battle_name_wh3_main_combi_region_jade_wind_mountain	Jade Wind Mountain	false
regions_battle_name_wh3_main_combi_region_jungles_of_chian	Jungles of Chi'an	false
regions_battle_name_wh3_main_combi_region_ka_sabar	Ka-Sabar	false
regions_battle_name_wh3_main_combi_region_kaiax	Kaiax	false
regions_battle_name_wh3_main_combi_region_kappelburg	Kappelburg	false
regions_battle_name_wh3_main_combi_region_karag_dromar	Karag Dromar	false
regions_battle_name_wh3_main_combi_region_karag_dron	Karag Dron	false
regions_battle_name_wh3_main_combi_region_karag_orrud	Karag Orrud	false
regions_battle_name_wh3_main_combi_region_karak_angazhar	Karak Angazhar	false
regions_battle_name_wh3_main_combi_region_karak_azgal	Karak Azgal	false
regions_battle_name_wh3_main_combi_region_karak_azgaraz	Karak Azgaraz	false
regions_battle_name_wh3_main_combi_region_karak_azorn	Karak Azorn	false
regions_battle_name_wh3_main_combi_region_karak_azul	Karak Azul	false
regions_battle_name_wh3_main_combi_region_karak_bhufdar	Karak Bhufdar	false
regions_battle_name_wh3_main_combi_region_karak_dum	Karak Dum	false
regions_battle_name_wh3_main_combi_region_karak_eight_peaks	Karak Eight Peaks	false
regions_battle_name_wh3_main_combi_region_karak_hirn	Karak Hirn	false
regions_battle_name_wh3_main_combi_region_karak_izor	Karak Izor	false
regions_battle_name_wh3_main_combi_region_karak_kadrin	Karak Kadrin	false
regions_battle_name_wh3_main_combi_region_karak_krakaten	Karak Krakaten	false
regions_battle_name_wh3_main_combi_region_karak_norn	Karak Norn	false
regions_battle_name_wh3_main_combi_region_karak_raziak	Karak Raziak	false
regions_battle_name_wh3_main_combi_region_karak_ungor	Karak Ungor	false
regions_battle_name_wh3_main_combi_region_karak_vlag	Karak Vlag	false
regions_battle_name_wh3_main_combi_region_karak_vrag	Karak Vrag	false
regions_battle_name_wh3_main_combi_region_karak_ziflin	Karak Ziflin	false
regions_battle_name_wh3_main_combi_region_karak_zorn	Karak Zorn	false
regions_battle_name_wh3_main_combi_region_karaz_a_karak	Karaz-a-Karak	false
regions_battle_name_wh3_main_combi_region_karond_kar	Karond Kar	false
regions_battle_name_wh3_main_combi_region_kauark	Kauark	false
regions_battle_name_wh3_main_combi_region_kemperbad	Kemperbad	false
regions_battle_name_wh3_main_combi_region_khazid_bordkarag	Lair of the Troll King	false
regions_battle_name_wh3_main_combi_region_khazid_irkulaz	Khazid Irkulaz	false
regions_battle_name_wh3_main_combi_region_khemri	Khemri	false
regions_battle_name_wh3_main_combi_region_khymerica_spire	Khymerica Spire	false
regions_battle_name_wh3_main_combi_region_kings_glade	King's Glade	false
regions_battle_name_wh3_main_combi_region_kislev	Kislev	false
regions_battle_name_wh3_main_combi_region_konquata	Konquata	false
regions_battle_name_wh3_main_combi_region_kradtommen	Kradtommen	false
regions_battle_name_wh3_main_combi_region_kraka_drak	Kraka Drak	false
regions_battle_name_wh3_main_combi_region_kraken_sea	Kraken Sea	false
regions_battle_name_wh3_main_combi_region_krugenheim	Krugenheim	false
regions_battle_name_wh3_main_combi_region_kunlan	Kunlan	false
regions_battle_name_wh3_main_combi_region_lahmia	Lahmia	false
regions_battle_name_wh3_main_combi_region_lake	Lake	false
regions_battle_name_wh3_main_combi_region_languille	L'Anguille	false
regions_battle_name_wh3_main_combi_region_lashiek	Lashiek	false
regions_battle_name_wh3_main_combi_region_laurelorn_forest	Laurelorn Forest	false
regions_battle_name_wh3_main_combi_region_li_temple	Li Temple	false
regions_battle_name_wh3_main_combi_region_li_zhu	Li Zhu	false
regions_battle_name_wh3_main_combi_region_lizard_sea	Lizard Sea	false
regions_battle_name_wh3_main_combi_region_longship_graveyard	Longship Graveyard	false
regions_battle_name_wh3_main_combi_region_lost_plateau	Lost Plateau	false
regions_battle_name_wh3_main_combi_region_lothern	Lothern	false
regions_battle_name_wh3_main_combi_region_luccini	Luccini	false
regions_battle_name_wh3_main_combi_region_lybaras	Lybaras	false
regions_battle_name_wh3_main_combi_region_lyonesse	Lyonesse	false
regions_battle_name_wh3_main_combi_region_macu_peaks	Macu Peaks	false
regions_battle_name_wh3_main_combi_region_magritta	Magritta	false
regions_battle_name_wh3_main_combi_region_mahrak	Mahrak	false
regions_battle_name_wh3_main_combi_region_mangrove_coast	Mangrove Coast	false
regions_battle_name_wh3_main_combi_region_mangrove_coast_sea	Mangrove Coast	false
regions_battle_name_wh3_main_combi_region_marienburg	Marienburg	false
regions_battle_name_wh3_main_combi_region_marks_of_the_old_ones	Marks of the Old Ones	false
regions_battle_name_wh3_main_combi_region_martek	Martek	false
regions_battle_name_wh3_main_combi_region_massif_orcal	Massif Orcal	false
regions_battle_name_wh3_main_combi_region_matorca	Matorca	false
regions_battle_name_wh3_main_combi_region_middenheim	Middenheim	false
regions_battle_name_wh3_main_combi_region_middenstag	Middenstag	false
regions_battle_name_wh3_main_combi_region_middle_sea	Middle Sea	false
regions_battle_name_wh3_main_combi_region_mighdal_vongalbarak	Mighdal Vongalbarak	false
regions_battle_name_wh3_main_combi_region_mine_of_the_bearded_skulls	Mine of the Bearded Skulls	false
regions_battle_name_wh3_main_combi_region_ming_zhu	Ming Zhu	false
regions_battle_name_wh3_main_combi_region_miragliano	Miragliano	false
regions_battle_name_wh3_main_combi_region_mistnar	Mistnar	false
regions_battle_name_wh3_main_combi_region_misty_mountain	Misty Mountain	false
regions_battle_name_wh3_main_combi_region_monolith_of_borkill_the_bloody_handed	Monolith of Borkill the Bloody-Handed	false
regions_battle_name_wh3_main_combi_region_monolith_of_bubonicus	Monolith of Bubonicus	false
regions_battle_name_wh3_main_combi_region_monolith_of_festerlung	Monolith of Festerlung	false
regions_battle_name_wh3_main_combi_region_monolith_of_flesh	The Monolith of Flesh	false
regions_battle_name_wh3_main_combi_region_montenas	Montenas	false
regions_battle_name_wh3_main_combi_region_montfort	Montfort	false
regions_battle_name_wh3_main_combi_region_monument_of_izzatal	Monument of Izzatal	false
regions_battle_name_wh3_main_combi_region_monument_of_the_moon	Monument of the Moon	false
regions_battle_name_wh3_main_combi_region_mordheim	Mordheim	false
regions_battle_name_wh3_main_combi_region_morgheim	Morgheim	false
regions_battle_name_wh3_main_combi_region_mount_arachnos	Mount Arachnos	false
regions_battle_name_wh3_main_combi_region_mount_athull	Mount Athull	false
regions_battle_name_wh3_main_combi_region_mount_grey_hag	Mount Grey Hag	false
regions_battle_name_wh3_main_combi_region_mount_gunbad	Mount Gunbad	false
regions_battle_name_wh3_main_combi_region_mount_silverspear	Mount Silverspear	false
regions_battle_name_wh3_main_combi_region_mount_squighorn	Mount Squighorn	false
regions_battle_name_wh3_main_combi_region_mount_thug	Mount Thug	false
regions_battle_name_wh3_main_combi_region_mousillon	Mousillon	false
regions_battle_name_wh3_main_combi_region_myrmidens	Myrmidens	false
regions_battle_name_wh3_main_combi_region_nagashizzar	Nagashizzar	false
regions_battle_name_wh3_main_combi_region_nagenhof	Nagenhof	false
regions_battle_name_wh3_main_combi_region_naggarond	Naggarond	false
regions_battle_name_wh3_main_combi_region_naglfari_plain	Naglfari Plain	false
regions_battle_name_wh3_main_combi_region_nagrar	Nagrar	false
regions_battle_name_wh3_main_combi_region_nahuontl	Nahuontl	false
regions_battle_name_wh3_main_combi_region_nan_gau	Nan-Gau	false
regions_battle_name_wh3_main_combi_region_nan_li	Nan-Li	false
regions_battle_name_wh3_main_combi_region_niedling	Niedling	false
regions_battle_name_wh3_main_combi_region_nonchang	Nongchang	false
regions_battle_name_wh3_main_combi_region_norden	Norden	false
regions_battle_name_wh3_main_combi_region_northern_sea_of_chaos	Northern Sea of Chaos	false
regions_battle_name_wh3_main_combi_region_northern_straits_of_the_great_ocean	Northern Straits of the Great Ocean	false
regions_battle_name_wh3_main_combi_region_northern_straits_of_the_jade_sea	Northern Straits of the Jade Sea	false
regions_battle_name_wh3_main_combi_region_novchozy	Novchozy	false
regions_battle_name_wh3_main_combi_region_nuja	Nuja	false
regions_battle_name_wh3_main_combi_region_nuln	Nuln	false
regions_battle_name_wh3_main_combi_region_numas	Numas	false
regions_battle_name_wh3_main_combi_region_oakenhammer	Oakenhammer	false
regions_battle_name_wh3_main_combi_region_okkams_forever_maze	Okkam's Forever Maze	false
regions_battle_name_wh3_main_combi_region_oreons_camp	Oreon's Camp	false
regions_battle_name_wh3_main_combi_region_oyxl	Oyxl	false
regions_battle_name_wh3_main_combi_region_pack_ice_bay	Pack Ice Bay	false
regions_battle_name_wh3_main_combi_region_pahuax	Pahuax	false
regions_battle_name_wh3_main_combi_region_palace_of_princes	Palace of Princes	false
regions_battle_name_wh3_main_combi_region_parravon	Parravon	false
regions_battle_name_wh3_main_combi_region_petrified_forest	Petrified Forest	false
regions_battle_name_wh3_main_combi_region_pfeildorf	Pfeildorf	false
regions_battle_name_wh3_main_combi_region_phoenix_gate	Phoenix Gate	false
regions_battle_name_wh3_main_combi_region_pigbarter	Pigbarter	false
regions_battle_name_wh3_main_combi_region_pillar_of_skulls	Pillar of Skulls	false
regions_battle_name_wh3_main_combi_region_pillars_of_unseen_constellations	Pillars of Unseen Constellations	false
regions_battle_name_wh3_main_combi_region_plain_of_dogs	Plain of Dogs	false
regions_battle_name_wh3_main_combi_region_plain_of_spiders	Plain of Spiders	false
regions_battle_name_wh3_main_combi_region_plain_of_tuskers	Plain of Tuskers	false
regions_battle_name_wh3_main_combi_region_po_mei	Po Mei	false
regions_battle_name_wh3_main_combi_region_pools_of_despair	Pools of Despair	false
regions_battle_name_wh3_main_combi_region_port_elistor	Port Elistor	false
regions_battle_name_wh3_main_combi_region_port_of_secrets	Port of Secrets	false
regions_battle_name_wh3_main_combi_region_port_reaver	Port Reaver	false
regions_battle_name_wh3_main_combi_region_pox_marsh	Pox Marsh	false
regions_battle_name_wh3_main_combi_region_praag	Praag	false
regions_battle_name_wh3_main_combi_region_qiang	Qiang	false
regions_battle_name_wh3_main_combi_region_quatar	Quatar	false
regions_battle_name_wh3_main_combi_region_quenelles	Quenelles	false
regions_battle_name_wh3_main_combi_region_quetza	Quetza	false
regions_battle_name_wh3_main_combi_region_quittax	Qu'ittax	false
regions_battle_name_wh3_main_combi_region_rackdo_gorge	Rackdo Gorge	false
regions_battle_name_wh3_main_combi_region_rasetra	Rasetra	false
regions_battle_name_wh3_main_combi_region_red_fortress	Red Fortress	false
regions_battle_name_wh3_main_combi_region_red_river	Red River	false
regions_battle_name_wh3_main_combi_region_riffraffa	Riffraffa	false
regions_battle_name_wh3_main_combi_region_river_reik	River Reik	false
regions_battle_name_wh3_main_combi_region_rothkar_spire	Rothkar Spire	false
regions_battle_name_wh3_main_combi_region_ruins_end	Ruin's End	false
regions_battle_name_wh3_main_combi_region_sabre_mountain	Sabre Mountain	false
regions_battle_name_wh3_main_combi_region_salzenmund	Salzenmund	false
regions_battle_name_wh3_main_combi_region_sarl_encampment	Sarl Encampment	false
regions_battle_name_wh3_main_combi_region_sartosa	Sartosa	false
regions_battle_name_wh3_main_combi_region_scarpels_lair	Scarpel's Lair	false
regions_battle_name_wh3_main_combi_region_scorpion_coast	Scorpion Coast	false
regions_battle_name_wh3_main_combi_region_sea_of_chill	Sea of Chill	false
regions_battle_name_wh3_main_combi_region_sea_of_claws	Sea of Claws	false
regions_battle_name_wh3_main_combi_region_sea_of_malice	Sea of Malice	false
regions_battle_name_wh3_main_combi_region_sea_of_serpents	Sea of Serpents	false
regions_battle_name_wh3_main_combi_region_sea_of_squalls	Sea of Squalls	false
regions_battle_name_wh3_main_combi_region_sea_of_storms	Sea of Storms	false
regions_battle_name_wh3_main_combi_region_sentinels_of_xeti	Sentinels of Xeti	false
regions_battle_name_wh3_main_combi_region_serpent_coast	Serpent Coast	false
regions_battle_name_wh3_main_combi_region_serpent_coast_sea	Serpent Coast	false
regions_battle_name_wh3_main_combi_region_serpent_jetty	Serpent Jetty	false
regions_battle_name_wh3_main_combi_region_serpent_river	Serpent River	false
regions_battle_name_wh3_main_combi_region_shagrath	Shagrath	false
regions_battle_name_wh3_main_combi_region_shang_wu	Shang-Wu	false
regions_battle_name_wh3_main_combi_region_shang_yang	Shang-Yang	false
regions_battle_name_wh3_main_combi_region_shard_bastion	Shard Bastion	false
regions_battle_name_wh3_main_combi_region_shark_straights	Shark Straits	false
regions_battle_name_wh3_main_combi_region_shattered_cove	Shattered Stone Bay	false
regions_battle_name_wh3_main_combi_region_shattered_stone_isle	Shattered Stone Isle	false
regions_battle_name_wh3_main_combi_region_shi_long	Shi Long	false
regions_battle_name_wh3_main_combi_region_shi_wu	Shi-Wu	false
regions_battle_name_wh3_main_combi_region_shifting_isles	Shifting Isles	false
regions_battle_name_wh3_main_combi_region_shifting_mangrove_coastline	Shifting Mangrove Coastline	false
regions_battle_name_wh3_main_combi_region_shiyamas_rest	Shiyama's Rest	false
regions_battle_name_wh3_main_combi_region_shrine_of_asuryan	Shrine of Asuryan	false
regions_battle_name_wh3_main_combi_region_shrine_of_khaine	Shrine of Khaine	false
regions_battle_name_wh3_main_combi_region_shrine_of_kurnous	Shrine of Kurnous	false
regions_battle_name_wh3_main_combi_region_shrine_of_ladrielle	Shrine of Ladrielle	false
regions_battle_name_wh3_main_combi_region_shrine_of_loec	Shrine of Loec	false
regions_battle_name_wh3_main_combi_region_shrine_of_sotek	Shrine of Sotek	false
regions_battle_name_wh3_main_combi_region_shrine_of_the_alchemist	Shrine of the Alchemist	false
regions_battle_name_wh3_main_combi_region_shroktak_mount	Shroktak Mount	false
regions_battle_name_wh3_main_combi_region_silver_pinnacle	Silver Pinnacle	false
regions_battle_name_wh3_main_combi_region_sjoktraken	Sjoktraken	false
regions_battle_name_wh3_main_combi_region_skavenblight	Skavenblight	false
regions_battle_name_wh3_main_combi_region_skeggi	Skeggi	false
regions_battle_name_wh3_main_combi_region_skrap_towers	Skrap Towers	false
regions_battle_name_wh3_main_combi_region_slavers_point	Slaver's Point	false
regions_battle_name_wh3_main_combi_region_snake_gate	Snake Gate	false
regions_battle_name_wh3_main_combi_region_sorcerers_islands	Sorcerers' Islands	false
regions_battle_name_wh3_main_combi_region_soteks_trail	Sotek's Trail	false
regions_battle_name_wh3_main_combi_region_southern_sea_of_chaos	Southern Sea of Chaos	false
regions_battle_name_wh3_main_combi_region_spektazuma	Spektazuma	false
regions_battle_name_wh3_main_combi_region_spite_reach	Spite Reach	false
regions_battle_name_wh3_main_combi_region_spitepeak	Spitepeak	false
regions_battle_name_wh3_main_combi_region_springs_of_eternal_life	Springs of Eternal Life	false
regions_battle_name_wh3_main_combi_region_ssildra_tor	Ss'ildra Tor	false
regions_battle_name_wh3_main_combi_region_statues_of_the_gods	Statues of the Gods	false
regions_battle_name_wh3_main_combi_region_steingart	Steingart	false
regions_battle_name_wh3_main_combi_region_stonemine_tower	Stonemine Tower	false
regions_battle_name_wh3_main_combi_region_storag_kor	Storag Kor	false
regions_battle_name_wh3_main_combi_region_stormhenge	Stormhenge	false
regions_battle_name_wh3_main_combi_region_stormvrack_mount	Stormvrack Mount	false
regions_battle_name_wh3_main_combi_region_straights_of_chaos	Straits of Chaos	false
regions_battle_name_wh3_main_combi_region_straits_of_fear	Straits of Fear	false
regions_battle_name_wh3_main_combi_region_straits_of_lothern	Straits of Lothern	false
regions_battle_name_wh3_main_combi_region_straits_of_nagash	Straits of Nagash	false
regions_battle_name_wh3_main_combi_region_subatuun	Subatuun	false
regions_battle_name_wh3_main_combi_region_sudenburg	Sudenburg	false
regions_battle_name_wh3_main_combi_region_sulpharets	Sulpharets	false
regions_battle_name_wh3_main_combi_region_sump_pit	Sump Pit	false
regions_battle_name_wh3_main_combi_region_sun_tree_glades	Sun-Tree Glades	false
regions_battle_name_wh3_main_combi_region_sunken_khernarch	Sunken Khernarch	false
regions_battle_name_wh3_main_combi_region_sunken_lands	Sunken Lands	false
regions_battle_name_wh3_main_combi_region_swamp_town	Swamp Town	false
regions_battle_name_wh3_main_combi_region_swartzhafen	Swartzhafen	false
regions_battle_name_wh3_main_combi_region_tai_tzu	Tai Tzu	false
regions_battle_name_wh3_main_combi_region_talabheim	Talabheim	false
regions_battle_name_wh3_main_combi_region_tarantula_coast	Tarantula Coast	false
regions_battle_name_wh3_main_combi_region_temple_avenue_of_gold	Temple Avenue of Gold	false
regions_battle_name_wh3_main_combi_region_temple_of_addaioth	Temple of Addaioth	false
regions_battle_name_wh3_main_combi_region_temple_of_elemental_winds	Temple of Elemental Winds	false
regions_battle_name_wh3_main_combi_region_temple_of_heimkel	Temple of Heimkel	false
regions_battle_name_wh3_main_combi_region_temple_of_kara	Temple of Kara	false
regions_battle_name_wh3_main_combi_region_temple_of_khaine	Temple of Khaine	false
regions_battle_name_wh3_main_combi_region_temple_of_skulls	Temple of Skulls	false
regions_battle_name_wh3_main_combi_region_temple_of_tlencan	Bregonne	false
regions_battle_name_wh3_main_combi_region_teotiqua	Teotiqua	false
regions_battle_name_wh3_main_combi_region_terracotta_graveyard	Terracotta Graveyard	false
regions_battle_name_wh3_main_combi_region_the_albion_channel	The Albion Channel	false
regions_battle_name_wh3_main_combi_region_the_awakening	The Awakening	false
regions_battle_name_wh3_main_combi_region_the_bitter_sea	The Bitter Sea	false
regions_battle_name_wh3_main_combi_region_the_black_forests	The Black Forests	false
regions_battle_name_wh3_main_combi_region_the_black_gulf	The Black Gulf	false
regions_battle_name_wh3_main_combi_region_the_black_pillar	The Black Pillar	false
regions_battle_name_wh3_main_combi_region_the_black_pit	The Black Pit	false
regions_battle_name_wh3_main_combi_region_the_bleak_coast	The Bleak Coast	false
regions_battle_name_wh3_main_combi_region_the_bleeding_spire	The Bleeding Spire	false
regions_battle_name_wh3_main_combi_region_the_blighted_grove	The Blighted Grove	false
regions_battle_name_wh3_main_combi_region_the_blood_hall	The Blood Hall	false
regions_battle_name_wh3_main_combi_region_the_blood_swamps	The Blood Swamps	false
regions_battle_name_wh3_main_combi_region_the_boiling_sea	The Boiling Sea	false
regions_battle_name_wh3_main_combi_region_the_bone_gulch	The Bone Gulch	false
regions_battle_name_wh3_main_combi_region_the_broken_lands	The Broken Lands	false
regions_battle_name_wh3_main_combi_region_the_burning_monolith	The Burning Monolith	false
regions_battle_name_wh3_main_combi_region_the_challenge_stone	The Challenge Stone	false
regions_battle_name_wh3_main_combi_region_the_churning_gulf	The Churning Gulf	false
regions_battle_name_wh3_main_combi_region_the_copper_landing	The Copper Landing	false
regions_battle_name_wh3_main_combi_region_the_crystal_spires	The Crystal Spires	false
regions_battle_name_wh3_main_combi_region_the_cursed_jungle	The Cursed Jungle	false
regions_battle_name_wh3_main_combi_region_the_daemonium_coast	The Daemonium Coast	false
regions_battle_name_wh3_main_combi_region_the_daemons_stump	The Daemon's Stump	false
regions_battle_name_wh3_main_combi_region_the_dust_gate	The Dust Gate	false
regions_battle_name_wh3_main_combi_region_the_eastern_isles	The Eastern Isles	false
regions_battle_name_wh3_main_combi_region_the_estalia_coastline	The Estalia Coastline	false
regions_battle_name_wh3_main_combi_region_the_falls_of_doom	The Falls of Doom	false
regions_battle_name_wh3_main_combi_region_the_far_sea	The Far Sea	false
regions_battle_name_wh3_main_combi_region_the_fetid_catacombs	The Fetid Catacombs	false
regions_battle_name_wh3_main_combi_region_the_folly_of_malofex	The Folly of Malofex	false
regions_battle_name_wh3_main_combi_region_the_forbidden_citadel	The Forbidden Citadel	false
regions_battle_name_wh3_main_combi_region_the_forbidding_coast	The Forbidding Coast	false
regions_battle_name_wh3_main_combi_region_the_forest_of_decay	The Forest of Decay	false
regions_battle_name_wh3_main_combi_region_the_fortress_of_vorag	The Fortress of Vorag	false
regions_battle_name_wh3_main_combi_region_the_frozen_city	The Frozen City	false
regions_battle_name_wh3_main_combi_region_the_galleons_graveyard	The Galleon's Graveyard	false
regions_battle_name_wh3_main_combi_region_the_galleons_graveyard_sea	The Galleon's Graveyard	false
regions_battle_name_wh3_main_combi_region_the_gallows_tree	The Gallows Tree	false
regions_battle_name_wh3_main_combi_region_the_gates_of_zharr	The Gates of Zharr	false
regions_battle_name_wh3_main_combi_region_the_godless_crater	The Godless Crater	false
regions_battle_name_wh3_main_combi_region_the_golden_colossus	The Golden Colossus	false
regions_battle_name_wh3_main_combi_region_the_golden_tower	The Golden Tower	false
regions_battle_name_wh3_main_combi_region_the_great_arena	The Great Arena	false
regions_battle_name_wh3_main_combi_region_the_great_ocean_north	The Great Ocean	false
regions_battle_name_wh3_main_combi_region_the_great_ocean_south	The Great Ocean	false
regions_battle_name_wh3_main_combi_region_the_haunted_forest	The Haunted Forest	false
regions_battle_name_wh3_main_combi_region_the_high_place	The High Place	false
regions_battle_name_wh3_main_combi_region_the_high_sentinel	The High Sentinel	false
regions_battle_name_wh3_main_combi_region_the_howling_citadel	The Howling Citadel	false
regions_battle_name_wh3_main_combi_region_the_inner_sea	The Inner Sea	false
regions_battle_name_wh3_main_combi_region_the_iron_coast	The Iron Coast	false
regions_battle_name_wh3_main_combi_region_the_isles	The Isles	false
regions_battle_name_wh3_main_combi_region_the_jade_sea	The Jade Sea	false
regions_battle_name_wh3_main_combi_region_the_lost_palace	The Lost Palace	false
regions_battle_name_wh3_main_combi_region_the_lustria_straight	The Lustria Strait	false
regions_battle_name_wh3_main_combi_region_the_maw_gate	The Maw Gate	false
regions_battle_name_wh3_main_combi_region_the_mistnar_crossing	The Mistnar Crossing	false
regions_battle_name_wh3_main_combi_region_the_monolith_of_katam	The Monolith of Katam	false
regions_battle_name_wh3_main_combi_region_the_monoliths	The Monoliths	false
regions_battle_name_wh3_main_combi_region_the_moon_shard	The Moon Shard	false
regions_battle_name_wh3_main_combi_region_the_moot	The Moot	false
regions_battle_name_wh3_main_combi_region_the_never_ending_chasm	The Never-ending Chasm	false
regions_battle_name_wh3_main_combi_region_the_oak_of_ages	The Oak of Ages	false
regions_battle_name_wh3_main_combi_region_the_palace_of_ruin	The Palace of Ruin	false
regions_battle_name_wh3_main_combi_region_the_pillars_of_grungni	The Pillars of Grungni	false
regions_battle_name_wh3_main_combi_region_the_pirate_coast	The Pirate Coast	false
regions_battle_name_wh3_main_combi_region_the_sacred_pools	The Sacred Pools	false
regions_battle_name_wh3_main_combi_region_the_sea_of_dread	The Sea of Dread	false
regions_battle_name_wh3_main_combi_region_the_sentinel_of_time	The Sentinel of Time	false
regions_battle_name_wh3_main_combi_region_the_sentinels	The Sentinels	false
regions_battle_name_wh3_main_combi_region_the_shard_coast	The Shard Coast	false
regions_battle_name_wh3_main_combi_region_the_silvered_tower_of_sorcerers	The Silvered Tower of Sorcerers	false
regions_battle_name_wh3_main_combi_region_the_sinhall_monolith	The Sinhall Monolith	false
regions_battle_name_wh3_main_combi_region_the_skull_carvers_abode	The Skull-Carver's Abode	false
regions_battle_name_wh3_main_combi_region_the_southern_sentinels	The Southern Sentinels	false
regions_battle_name_wh3_main_combi_region_the_southern_straits	The Southern Straits	false
regions_battle_name_wh3_main_combi_region_the_star_tower	The Star Tower	false
regions_battle_name_wh3_main_combi_region_the_tower_of_flies	The Tower of Flies	false
regions_battle_name_wh3_main_combi_region_the_tower_of_khrakk	The Tower of Khrakk	false
regions_battle_name_wh3_main_combi_region_the_tower_of_torment	The Tower of Torment	false
regions_battle_name_wh3_main_combi_region_the_turtle_shallows	The Turtle Shallows	false
regions_battle_name_wh3_main_combi_region_the_twisted_glade	The Twisted Glade	false
regions_battle_name_wh3_main_combi_region_the_twisted_towers	The Twisted Towers	false
regions_battle_name_wh3_main_combi_region_the_vampire_coast_sea	The Vampire Coast	false
regions_battle_name_wh3_main_combi_region_the_volary	The Volary	false
regions_battle_name_wh3_main_combi_region_the_witchwood	The Witchwood	false
regions_battle_name_wh3_main_combi_region_the_writhing_fortress	The Writhing Fortress	false
regions_battle_name_wh3_main_combi_region_thrice_cursed_peak	Thrice-cursed Peak	false
regions_battle_name_wh3_main_combi_region_tilean_sea	Tilean Sea	false
regions_battle_name_wh3_main_combi_region_titans_notch	Titan's Notch	false
regions_battle_name_wh3_main_combi_region_tlanxla	Tlanxla	false
regions_battle_name_wh3_main_combi_region_tlaqua	Tlaqua	false
regions_battle_name_wh3_main_combi_region_tlax	Tlax	false
regions_battle_name_wh3_main_combi_region_tlaxtlan	Tlaxtlan	false
regions_battle_name_wh3_main_combi_region_tobaro	Tobaro	false
regions_battle_name_wh3_main_combi_region_tor_achare	Tor Achare	false
regions_battle_name_wh3_main_combi_region_tor_anlec	Tor Anlec	false
regions_battle_name_wh3_main_combi_region_tor_anroc	Tor Anroc	false
regions_battle_name_wh3_main_combi_region_tor_dranil	Tor Dranil	false
regions_battle_name_wh3_main_combi_region_tor_elasor	Tor Elasor	false
regions_battle_name_wh3_main_combi_region_tor_elyr	Tor Elyr	false
regions_battle_name_wh3_main_combi_region_tor_finu	Tor Finu	false
regions_battle_name_wh3_main_combi_region_tor_koruali	Tor Koruali	false
regions_battle_name_wh3_main_combi_region_tor_saroir	Tor Saroir	false
regions_battle_name_wh3_main_combi_region_tor_sethai	Tor Sethai	false
regions_battle_name_wh3_main_combi_region_tor_surpindar	Tor Surpindar	false
regions_battle_name_wh3_main_combi_region_tor_yvresse	Tor Yvresse	false
regions_battle_name_wh3_main_combi_region_tower_of_ashung	Tower of Ashung	false
regions_battle_name_wh3_main_combi_region_tower_of_gorgoth	Tower of Gorgoth	false
regions_battle_name_wh3_main_combi_region_tower_of_lysean	Tower of Lysean	false
regions_battle_name_wh3_main_combi_region_tower_of_the_stars	Tower of the Stars	false
regions_battle_name_wh3_main_combi_region_tower_of_the_sun	Tower of the Sun	false
regions_battle_name_wh3_main_combi_region_tralinia	Tralinia	false
regions_battle_name_wh3_main_combi_region_tribeslaughter	Tribeslaughter	false
regions_battle_name_wh3_main_combi_region_troll_fjord	Troll Fjord	false
regions_battle_name_wh3_main_combi_region_turtle_gate	Turtle Gate	false
regions_battle_name_wh3_main_combi_region_tyrant_peak	Tyrant Peak	false
regions_battle_name_wh3_main_combi_region_ubersreik	Ubersreik	false
regions_battle_name_wh3_main_combi_region_unicorn_gate	Unicorn Gate	false
regions_battle_name_wh3_main_combi_region_uzkulak	Uzkulak	false
regions_battle_name_wh3_main_combi_region_valayas_sorrow	Valaya's Sorrow	false
regions_battle_name_wh3_main_combi_region_vale_of_titans	Vale of Titans	false
regions_battle_name_wh3_main_combi_region_valley_of_horns	Valley of Horns	false
regions_battle_name_wh3_main_combi_region_varenka_hills	Varenka Hills	false
regions_battle_name_wh3_main_combi_region_varg_camp	Varg Camp	false
regions_battle_name_wh3_main_combi_region_vauls_anvil_loren	Vaul's Anvil	false
regions_battle_name_wh3_main_combi_region_vauls_anvil_naggaroth	Vaul's Anvil	false
regions_battle_name_wh3_main_combi_region_vauls_anvil_ulthuan	Vaul's Anvil	false
regions_battle_name_wh3_main_combi_region_venom_glade	Venom Glade	false
regions_battle_name_wh3_main_combi_region_verdanos	Verdanos	false
regions_battle_name_wh3_main_combi_region_village_of_the_moon	Village of the Moon	false
regions_battle_name_wh3_main_combi_region_village_of_the_tigermen	Village of the Tigermen	false
regions_battle_name_wh3_main_combi_region_vitevo	Vitevo	false
regions_battle_name_wh3_main_combi_region_volcanos_heart	Volcano's Heart	false
regions_battle_name_wh3_main_combi_region_volksgrad	Volksgrad	false
regions_battle_name_wh3_main_combi_region_volulltrax	Volulltrax	false
regions_battle_name_wh3_main_combi_region_vulture_mountain	Vulture Mountain	false
regions_battle_name_wh3_main_combi_region_waili_village	Wai-Li Village	false
regions_battle_name_wh3_main_combi_region_waldenhof	Waldenhof	false
regions_battle_name_wh3_main_combi_region_waterfall_palace	Waterfall Palace	false
regions_battle_name_wh3_main_combi_region_wei_jin	Wei-Jin	false
regions_battle_name_wh3_main_combi_region_weismund	Weismund	false
regions_battle_name_wh3_main_combi_region_wellsprings_of_eternity	Wellsprings of Eternity	false
regions_battle_name_wh3_main_combi_region_weng_chang	Weng Chang	false
regions_battle_name_wh3_main_combi_region_white_tower_of_hoeth	White Tower of Hoeth	false
regions_battle_name_wh3_main_combi_region_whitefire_tor	Whitefire Tor	false
regions_battle_name_wh3_main_combi_region_whitepeak	Whitepeak	false
regions_battle_name_wh3_main_combi_region_winter_pyre	Winter Pyre	false
regions_battle_name_wh3_main_combi_region_wissenburg	Wissenburg	false
regions_battle_name_wh3_main_combi_region_witch_sea	Witch Sea	false
regions_battle_name_wh3_main_combi_region_wizard_caliphs_palace	Wizard Caliph's Palace	false
regions_battle_name_wh3_main_combi_region_wolfenburg	Wolfenburg	false
regions_battle_name_wh3_main_combi_region_worlds_edge_archway	World's Edge Archway	false
regions_battle_name_wh3_main_combi_region_worm_coast	Worm Coast	false
regions_battle_name_wh3_main_combi_region_wreckers_point	Wrecker's Point	false
regions_battle_name_wh3_main_combi_region_wurtbad	Wurtbad	false
regions_battle_name_wh3_main_combi_region_xahutec	Xahutec	false
regions_battle_name_wh3_main_combi_region_xen_wu	Xen Wu	false
regions_battle_name_wh3_main_combi_region_xhotl	Xhotl	false
regions_battle_name_wh3_main_combi_region_xing_po	Xing Po	false
regions_battle_name_wh3_main_combi_region_xlanhuapec	Xlanhuapec	false
regions_battle_name_wh3_main_combi_region_xlanzec	Xlanzec	false
regions_battle_name_wh3_main_combi_region_yetchitch	Yetchitch	false
regions_battle_name_wh3_main_combi_region_yhetee_peak	Yhetee Peak	false
regions_battle_name_wh3_main_combi_region_yuatek	Yuatek	false
regions_battle_name_wh3_main_combi_region_zanbaijin	Zanbaijin	false
regions_battle_name_wh3_main_combi_region_zandri	Zandri	false
regions_battle_name_wh3_main_combi_region_zarakzil	Zarakzil	false
regions_battle_name_wh3_main_combi_region_zavastra	Zavastra	false
regions_battle_name_wh3_main_combi_region_zhanshi	Zhanshi	false
regions_battle_name_wh3_main_combi_region_zharr_naggrund	Zharr Naggrund	false
regions_battle_name_wh3_main_combi_region_zhizhu	Zhi-Zhu	false
regions_battle_name_wh3_main_combi_region_zhufbar	Zhufbar	false
regions_battle_name_wh3_main_combi_region_ziggurat_of_dawn	Ziggurat of Dawn	false
regions_battle_name_wh3_main_combi_region_zlatlan	Zlatlan	false
regions_battle_name_wh3_main_combi_region_zoishenk	Zoishenk	false
regions_battle_name_wh3_main_combi_region_zvorak	Zvorak	false
regions_battle_name_wh3_main_prologue_region_unknown_terrain	Unknown Terrain	false
regions_battle_name_wh3_prologue_region_broken_lands_tong_hall	Tong-Hall	false
regions_battle_name_wh3_prologue_region_canyons_of_gore_gore_town	Gore-Town	false
regions_battle_name_wh3_prologue_region_crimson_vale_hall_of_the_keepers	Hall of the Keepers	false
regions_battle_name_wh3_prologue_region_dervingard_outskirts	Dervingard Outskirts	false
regions_battle_name_wh3_prologue_region_fleshlands_blood_haven	Blood-Haven	false
regions_battle_name_wh3_prologue_region_frozen_plains_dervingard	Fort Dervingard	false
regions_battle_name_wh3_prologue_region_ice_canyon_beacon_fort	Beacon	false
regions_battle_name_wh3_prologue_region_icecaid_pass_claw_reach	Claw Reach	false
regions_battle_name_wh3_prologue_region_kislev_encampment_outskirts	Kislev Refuge Outskirts	false
regions_battle_name_wh3_prologue_region_mirror_marshes_the_loci_palace	The Loci Palace	false
regions_battle_name_wh3_prologue_region_mountain_pass_kislev_refuge	Kislev Refuge	false
regions_battle_name_wh3_prologue_region_plains_of_brass_the_tah_camp	The Tah-Camp	false
regions_battle_name_wh3_prologue_region_river_of_the_flux_the_fording_place	The Fording Place	false
regions_battle_name_wh3_prologue_region_sea	Sea	false
regions_battle_name_wh3_prologue_region_temp_2	Uncanny Mountains	false
regions_battle_name_wh3_prologue_region_temp_3	The Lucent Maze	false
regions_battle_name_wh3_prologue_region_temp_4	The Screaming Chasm	false
regions_battle_name_wh3_prologue_region_temp_5	The Howling Citadel	false
regions_battle_name_wh3_prologue_region_temp_6	Beacon Outskirts	false
regions_battle_name_wh3_prologue_region_the_brazen_lands	The Brazen Lands	false
regions_battle_name_wh3_prologue_region_the_falls_of_circatrex_the_rookery	The Rookery	false
regions_battle_name_wh3_prologue_region_the_maze_keep_mansion_of_eyes	Mansion of Eyes	false
regions_battle_name_wh3_prologue_region_the_scarlet_steppes_the_blood_moot	The Blood-Moot	false
regions_battle_name_wh3_prologue_region_the_void_steppes_the_monolith_of_the_void	The Monolith of the Void	false
regions_battle_name_wh_main_unknown_terrain	Unknown Terrain	false
regions_onscreen_wh3_dlc20_chaos_region_black_pit	The Black Pit	false
regions_onscreen_wh3_dlc20_chaos_region_chantillon	Chantillon	false
regions_onscreen_wh3_dlc20_chaos_region_citadel_of_lead	Citadel of Lead	false
regions_onscreen_wh3_dlc20_chaos_region_fort_sollace	Fort Solace	false
regions_onscreen_wh3_dlc20_chaos_region_grung_zint	Grung Zint	false
regions_onscreen_wh3_dlc20_chaos_region_losteriksons_landing	Losterikson's Landing	false
regions_onscreen_wh3_dlc20_chaos_region_neuland	Neuland	false
regions_onscreen_wh3_dlc20_chaos_region_river_reik	River Reik	false
regions_onscreen_wh3_dlc20_chaos_region_tancred_castle	Tancred Castle	false
regions_onscreen_wh3_dlc20_chaos_region_wreckers_point	Wrecker's Point	false
regions_onscreen_wh3_dlc20_chaos_region_zanbaijin	Zanbaijin	false
regions_onscreen_wh3_dlc20_combi_region_dragons_death	Dragon's Death	false
regions_onscreen_wh3_dlc20_combi_region_glacial_gardens	The Glacial Gardens	false
regions_onscreen_wh3_dlc20_combi_region_glacier_encampment	Glacier Encampment	false
regions_onscreen_wh3_dlc20_combi_region_krudenwald	Krudenwald	false
regions_onscreen_wh3_main_chaos_region_altar_of_spawns	Altar of Spawns	false
regions_onscreen_wh3_main_chaos_region_altar_of_the_crimson_harvest	Altar of the Crimson Harvest	false
regions_onscreen_wh3_main_chaos_region_altdorf	Altdorf	false
regions_onscreen_wh3_main_chaos_region_amblepeak	Amblepeak	false
regions_onscreen_wh3_main_chaos_region_bay_of_blades	Bay of Blades	false
regions_onscreen_wh3_main_chaos_region_bechafen	Bechafen	false
regions_onscreen_wh3_main_chaos_region_black_fang	Black Fang	false
regions_onscreen_wh3_main_chaos_region_black_fortress	Black Fortress	false
regions_onscreen_wh3_main_chaos_region_black_gulch	Black Gulch	false
regions_onscreen_wh3_main_chaos_region_black_rock	Black Rock	false
regions_onscreen_wh3_main_chaos_region_blackstone_tower	Blackstone Tower	false
regions_onscreen_wh3_main_chaos_region_blizzardpeak	Blizzardpeak	false
regions_onscreen_wh3_main_chaos_region_blood_haven	Blood-Haven	false
regions_onscreen_wh3_main_chaos_region_blood_mountain	Blood Mountain	false
regions_onscreen_wh3_main_chaos_region_bloodpeak	Bloodpeak	false
regions_onscreen_wh3_main_chaos_region_bloodwind_keep	Bloodwind Keep	false
regions_onscreen_wh3_main_chaos_region_bohsenfels	Bohsenfels	false
regions_onscreen_wh3_main_chaos_region_bolgasgrad	Bolgasgrad	false
regions_onscreen_wh3_main_chaos_region_brass_keep	Brass Keep	false
regions_onscreen_wh3_main_chaos_region_bridge_of_brass	Bridge of Brass	false
regions_onscreen_wh3_main_chaos_region_bridge_of_heaven	Bridge of Heaven	false
regions_onscreen_wh3_main_chaos_region_broekwater	Broekwater	false
regions_onscreen_wh3_main_chaos_region_castle_alexandronov	Castle Alexandronov	false
regions_onscreen_wh3_main_chaos_region_castle_drachenfels	Castle Drachenfels	false
regions_onscreen_wh3_main_chaos_region_castle_drakenhof	Castle Drakenhof	false
regions_onscreen_wh3_main_chaos_region_chasm_of_torment	Chasm of Torment	false
regions_onscreen_wh3_main_chaos_region_chimera_plateau	Chimera Plateau	false
regions_onscreen_wh3_main_chaos_region_city_of_monkeys	City of Monkeys	false
regions_onscreen_wh3_main_chaos_region_city_of_splinters	City of Splinters	false
regions_onscreen_wh3_main_chaos_region_city_of_the_shugengan	City of the Shugengan	false
regions_onscreen_wh3_main_chaos_region_cliff_of_beasts	Cliff of Beasts	false
regions_onscreen_wh3_main_chaos_region_crookback_mountain	Crookback Mountain	false
regions_onscreen_wh3_main_chaos_region_darkhold	Darkhold	false
regions_onscreen_wh3_main_chaos_region_delberz	Delberz	false
regions_onscreen_wh3_main_chaos_region_dharko_wharf	Dharko Wharf	false
regions_onscreen_wh3_main_chaos_region_dhazhyn	Dhazhyn	false
regions_onscreen_wh3_main_chaos_region_dietershafen	Dietershafen	false
regions_onscreen_wh3_main_chaos_region_doomkeep	Doomkeep	false
regions_onscreen_wh3_main_chaos_region_dragon_fang_mount	Dragon Fang Mount	false
regions_onscreen_wh3_main_chaos_region_dragon_gate	Dragon Gate	false
regions_onscreen_wh3_main_chaos_region_dragon_river	Dragon River	false
regions_onscreen_wh3_main_chaos_region_dragons_crossroad	Dragon's Crossroad	false
regions_onscreen_wh3_main_chaos_region_dragons_death	Dragon's Death	false
regions_onscreen_wh3_main_chaos_region_dushyka	Dushyka	false
regions_onscreen_wh3_main_chaos_region_eagle_eyries	Eagle Eyries	false
regions_onscreen_wh3_main_chaos_region_eilhart	Eilhart	false
regions_onscreen_wh3_main_chaos_region_erengrad	Erengrad	false
regions_onscreen_wh3_main_chaos_region_fallen_city	Fallen City	false
regions_onscreen_wh3_main_chaos_region_fire_mouth	Fire Mouth	false
regions_onscreen_wh3_main_chaos_region_floating_mountain	Floating Mountain	false
regions_onscreen_wh3_main_chaos_region_fort_bergbres	Fort Bergbres	false
regions_onscreen_wh3_main_chaos_region_fort_dolganyeir	Fort Dolganyeir	false
regions_onscreen_wh3_main_chaos_region_fort_dorznye_vort	Fort Dorznye-vort	false
regions_onscreen_wh3_main_chaos_region_fort_jakova	Fort Jakova	false
regions_onscreen_wh3_main_chaos_region_fort_ostrosk	Fort Ostrosk	false
regions_onscreen_wh3_main_chaos_region_fort_straghov	Lair of the Troll King	false
regions_onscreen_wh3_main_chaos_region_fortenhof	Fortenhof	false
regions_onscreen_wh3_main_chaos_region_fortress_of_eyes	Fortress of Eyes	false
regions_onscreen_wh3_main_chaos_region_fortress_of_the_damned	Fortress of the Damned	false
regions_onscreen_wh3_main_chaos_region_foul_fortress	Foul Fortress	false
regions_onscreen_wh3_main_chaos_region_foundry_of_bones	Foundry of Bones	false
regions_onscreen_wh3_main_chaos_region_frozen_landing	Frozen Landing	false
regions_onscreen_wh3_main_chaos_region_frozen_sea	Frozen Sea	false
regions_onscreen_wh3_main_chaos_region_gerslev	Gerslev	false
regions_onscreen_wh3_main_chaos_region_glut_port	Glut-port	false
regions_onscreen_wh3_main_chaos_region_gnashraks_lair	Gnashrak's Lair	false
regions_onscreen_wh3_main_chaos_region_gorger_rock	Gorger Rock	false
regions_onscreen_wh3_main_chaos_region_gorssel	Gorssel	false
regions_onscreen_wh3_main_chaos_region_graeling_moot	Graeling Moot	false
regions_onscreen_wh3_main_chaos_region_granite_spikes	Granite Spikes	false
regions_onscreen_wh3_main_chaos_region_great_hall_of_greasus	Great Hall of Greasus	false
regions_onscreen_wh3_main_chaos_region_great_river	Great River	false
regions_onscreen_wh3_main_chaos_region_grim_duraz	Grim Duraz	false
regions_onscreen_wh3_main_chaos_region_grimtop	Grimtop	false
regions_onscreen_wh3_main_chaos_region_grissenwald	Grissenwald	false
regions_onscreen_wh3_main_chaos_region_gristle_valley	Gristle Valley	false
regions_onscreen_wh3_main_chaos_region_hanyu_port	Hanyu Port	false
regions_onscreen_wh3_main_chaos_region_hell_pit	Hell Pit	false
regions_onscreen_wh3_main_chaos_region_hellcade_drove	Hellcade Drove	false
regions_onscreen_wh3_main_chaos_region_hergig	Hergig	false
regions_onscreen_wh3_main_chaos_region_hissing_pits	Hissing Pits	false
regions_onscreen_wh3_main_chaos_region_howling_rock	Howling Rock	false
regions_onscreen_wh3_main_chaos_region_ice_caverns_of_ymirdrak	Ice Caverns of Ymirdrak	false
regions_onscreen_wh3_main_chaos_region_icedrake_fjord	Icedrake Fjord	false
regions_onscreen_wh3_main_chaos_region_icespewer	Icespewer	false
regions_onscreen_wh3_main_chaos_region_igerov	Igerov	false
regions_onscreen_wh3_main_chaos_region_infernius	Infernius	false
regions_onscreen_wh3_main_chaos_region_iron_storm	Iron Storm	false
regions_onscreen_wh3_main_chaos_region_jade_river	Jade River	false
regions_onscreen_wh3_main_chaos_region_jade_wind_mountain	Jade Wind Mountain	false
regions_onscreen_wh3_main_chaos_region_karak_azgaraz	Karak Azgaraz	false
regions_onscreen_wh3_main_chaos_region_karak_azorn	Karak Azorn	false
regions_onscreen_wh3_main_chaos_region_karak_dum	Karak Dum	false
regions_onscreen_wh3_main_chaos_region_karak_kadrin	Karak Kadrin	false
regions_onscreen_wh3_main_chaos_region_karak_krakaten	Karak Krakaten	false
regions_onscreen_wh3_main_chaos_region_karak_raziak	Karak Raziak	false
regions_onscreen_wh3_main_chaos_region_karak_ungor	Karak Ungor	false
regions_onscreen_wh3_main_chaos_region_karak_vlag	Karak Vlag	false
regions_onscreen_wh3_main_chaos_region_karak_vrag	Karak Vrag	false
regions_onscreen_wh3_main_chaos_region_karak_ziflin	Karak Ziflin	false
regions_onscreen_wh3_main_chaos_region_khazid_irkulaz	Khazid Irkulaz	false
regions_onscreen_wh3_main_chaos_region_kislev	Kislev	false
regions_onscreen_wh3_main_chaos_region_konigstein_tower	Konigstein Tower	false
regions_onscreen_wh3_main_chaos_region_kraka_dorden	Kraka Dorden	false
regions_onscreen_wh3_main_chaos_region_kraka_drak	Kraka Drak	false
regions_onscreen_wh3_main_chaos_region_kraken_sea	Kraken Sea	false
regions_onscreen_wh3_main_chaos_region_kraz_und	Kraz Und	false
regions_onscreen_wh3_main_chaos_region_krudenwald	Krudenwald	false
regions_onscreen_wh3_main_chaos_region_kunlan	Kunlan	false
regions_onscreen_wh3_main_chaos_region_kurak_peak	Kurak Peak	false
regions_onscreen_wh3_main_chaos_region_kusel	KÃ¼sel	false
regions_onscreen_wh3_main_chaos_region_land_of_the_plaguelord	Land of the Plaguelord	false
regions_onscreen_wh3_main_chaos_region_laurelorn_forest	Laurelorn Forest	false
regions_onscreen_wh3_main_chaos_region_leblya	Leblya	false
regions_onscreen_wh3_main_chaos_region_longship_graveyard	Longship Graveyard	false
regions_onscreen_wh3_main_chaos_region_marienburg	Marienburg	false
regions_onscreen_wh3_main_chaos_region_middenheim	Middenheim	false
regions_onscreen_wh3_main_chaos_region_mines_of_gorgoth	Mines of Gorgoth	false
regions_onscreen_wh3_main_chaos_region_mines_of_nan_yang	Mines of Nan-Yang	false
regions_onscreen_wh3_main_chaos_region_ming_zhu	Ming Zhu	false
regions_onscreen_wh3_main_chaos_region_mist_gorge	Mist Gorge	false
regions_onscreen_wh3_main_chaos_region_mount_cragg	Mount Cragg	false
regions_onscreen_wh3_main_chaos_region_mount_grey_hag	Mount Grey Hag	false
regions_onscreen_wh3_main_chaos_region_mount_grimfang	Mount Grimfang	false
regions_onscreen_wh3_main_chaos_region_mount_gunbad	Mount Gunbad	false
regions_onscreen_wh3_main_chaos_region_mount_thug	Mount Thug	false
regions_onscreen_wh3_main_chaos_region_nan_gau	Nan-Gau	false
regions_onscreen_wh3_main_chaos_region_nan_li	Nan-Li	false
regions_onscreen_wh3_main_chaos_region_nonchang	Nongchang	false
regions_onscreen_wh3_main_chaos_region_norden	Norden	false
regions_onscreen_wh3_main_chaos_region_novchozy	Novchozy	false
regions_onscreen_wh3_main_chaos_region_nuln	Nuln	false
regions_onscreen_wh3_main_chaos_region_oakenhammer	Oakenhammer	false
regions_onscreen_wh3_main_chaos_region_osterwald	Osterwald	false
regions_onscreen_wh3_main_chaos_region_pack_ice_bay	Pack Ice Bay	false
regions_onscreen_wh3_main_chaos_region_palace_of_princes	Palace of Princes	false
regions_onscreen_wh3_main_chaos_region_pigbarter	Pigbarter	false
regions_onscreen_wh3_main_chaos_region_pillar_of_skulls	Pillar of Skulls	false
regions_onscreen_wh3_main_chaos_region_plesk	Plesk	false
regions_onscreen_wh3_main_chaos_region_po_mei	Po Mei	false
regions_onscreen_wh3_main_chaos_region_praag	Praag	false
regions_onscreen_wh3_main_chaos_region_qiang	Qiang	false
regions_onscreen_wh3_main_chaos_region_realm_of_chaos	The Realm of Chaos	false
regions_onscreen_wh3_main_chaos_region_realm_of_the_sorcerer_1	Realm of the Sorcerer	false
regions_onscreen_wh3_main_chaos_region_realm_of_the_sorcerer_2	Realm of the Sorcerer	false
regions_onscreen_wh3_main_chaos_region_realm_of_the_sorcerer_3	Realm of the Sorcerer	false
regions_onscreen_wh3_main_chaos_region_realm_of_the_sorcerer_4	Realm of the Sorcerer	false
regions_onscreen_wh3_main_chaos_region_realm_of_the_sorcerer_5	Realm of the Sorcerer	false
regions_onscreen_wh3_main_chaos_region_realm_of_the_sorcerer_6	Realm of the Sorcerer	false
regions_onscreen_wh3_main_chaos_region_realm_of_the_sorcerer_7	Realm of the Sorcerer	false
regions_onscreen_wh3_main_chaos_region_red_fortress	Red Fortress	false
regions_onscreen_wh3_main_chaos_region_rosche	Rosche	false
regions_onscreen_wh3_main_chaos_region_sabre_mountain	Sabre Mountain	false
regions_onscreen_wh3_main_chaos_region_salzenmund	Salzenmund	false
regions_onscreen_wh3_main_chaos_region_sea_of_chaos	Sea of Chaos	false
regions_onscreen_wh3_main_chaos_region_sea_of_claws	Sea of Claws	false
regions_onscreen_wh3_main_chaos_region_seep_gore	Seep-Gore	false
regions_onscreen_wh3_main_chaos_region_sepukzy	Sepukzy	false
regions_onscreen_wh3_main_chaos_region_serpent_jetty	Serpent Jetty	false
regions_onscreen_wh3_main_chaos_region_shambletown	Shambletown	false
regions_onscreen_wh3_main_chaos_region_shang_wu	Shang-Wu	false
regions_onscreen_wh3_main_chaos_region_shang_yang	Shang-Yang	false
regions_onscreen_wh3_main_chaos_region_shattered_stone_bay	Shattered Stone Bay	false
regions_onscreen_wh3_main_chaos_region_shi_long	Shi Long	false
regions_onscreen_wh3_main_chaos_region_shrine_of_the_alchemist	Shrine of the Alchemist	false
regions_onscreen_wh3_main_chaos_region_siegfriedhof	Siegfriedhof	false
regions_onscreen_wh3_main_chaos_region_sjoktraken	Sjoktraken	false
regions_onscreen_wh3_main_chaos_region_skrap_towers	Skrap Towers	false
regions_onscreen_wh3_main_chaos_region_slaanesh_fifth	The Circle of Vainglory	false
regions_onscreen_wh3_main_chaos_region_slaanesh_first	The Circle of Avidity	false
regions_onscreen_wh3_main_chaos_region_slaanesh_fourth	The Circle of Paramountcy	false
regions_onscreen_wh3_main_chaos_region_slaanesh_second	The Circle of Gluttony	false
regions_onscreen_wh3_main_chaos_region_slaanesh_sixth	The Circle of Indolency	false
regions_onscreen_wh3_main_chaos_region_slaanesh_start_01	The Dark Prince's Realm	false
regions_onscreen_wh3_main_chaos_region_slaanesh_start_02	The Dark Prince's Realm	false
regions_onscreen_wh3_main_chaos_region_slaanesh_start_03	The Dark Prince's Realm	false
regions_onscreen_wh3_main_chaos_region_slaanesh_start_04	The Dark Prince's Realm	false
regions_onscreen_wh3_main_chaos_region_slaanesh_start_05	The Dark Prince's Realm	false
regions_onscreen_wh3_main_chaos_region_slaanesh_start_06	The Dark Prince's Realm	false
regions_onscreen_wh3_main_chaos_region_slaanesh_start_07	The Dark Prince's Realm	false
regions_onscreen_wh3_main_chaos_region_slaanesh_start_08	The Dark Prince's Realm	false
regions_onscreen_wh3_main_chaos_region_slaanesh_third	The Circle of Carnality	false
regions_onscreen_wh3_main_chaos_region_snake_gate	Snake Gate	false
regions_onscreen_wh3_main_chaos_region_stormvrack_mount	Stormvrack Mount	false
regions_onscreen_wh3_main_chaos_region_tai_tzu	Tai Tzu	false
regions_onscreen_wh3_main_chaos_region_talabheim	Talabheim	false
regions_onscreen_wh3_main_chaos_region_temple_of_elemental_winds	Temple of Elemental Winds	false
regions_onscreen_wh3_main_chaos_region_temple_of_heimkel	Temple of Heimkel	false
regions_onscreen_wh3_main_chaos_region_terracotta_graveyard	Terracotta Graveyard	false
regions_onscreen_wh3_main_chaos_region_the_bleeding_spire	The Bleeding Spire	false
regions_onscreen_wh3_main_chaos_region_the_blighted_grove	The Blighted Grove	false
regions_onscreen_wh3_main_chaos_region_the_blood_gods_domain	The Blood God's Domain	false
regions_onscreen_wh3_main_chaos_region_the_brass_glacier	The Brass Glacier	false
regions_onscreen_wh3_main_chaos_region_the_burning_monolith	The Burning Monolith	false
regions_onscreen_wh3_main_chaos_region_the_challenge_stone	The Challenge Stone	false
regions_onscreen_wh3_main_chaos_region_the_crystal_spires	The Crystal Spires	false
regions_onscreen_wh3_main_chaos_region_the_daemons_stump	The Daemon's Stump	false
regions_onscreen_wh3_main_chaos_region_the_dark_princes_realm	The Dark Prince's Realm	false
regions_onscreen_wh3_main_chaos_region_the_falls_of_doom	The Falls of Doom	false
regions_onscreen_wh3_main_chaos_region_the_fetid_catacombs	The Fetid Catacombs	false
regions_onscreen_wh3_main_chaos_region_the_folly_of_malofex	The Folly of Malofex	false
regions_onscreen_wh3_main_chaos_region_the_forbidden_citadel	The Forbidden Citadel	false
regions_onscreen_wh3_main_chaos_region_the_forest_of_decay	The Forest of Decay	false
regions_onscreen_wh3_main_chaos_region_the_forge_of_souls	The Forge of Souls	false
regions_onscreen_wh3_main_chaos_region_the_fortress_of_vorag	The Fortress of Vorag	false
regions_onscreen_wh3_main_chaos_region_the_gallows_tree	The Gallows Tree	false
regions_onscreen_wh3_main_chaos_region_the_gates_of_zharr	The Gates of Zharr	false
regions_onscreen_wh3_main_chaos_region_the_gulf_of_kislev	The Gulf of Kislev	false
regions_onscreen_wh3_main_chaos_region_the_last_sky_castle	The Last Sky Castle	false
regions_onscreen_wh3_main_chaos_region_the_monolith_of_katam	The Monolith of Katam	false
regions_onscreen_wh3_main_chaos_region_the_monolith_of_kjarl_deathaxe	Deathaxe's Monolith	false
regions_onscreen_wh3_main_chaos_region_the_monolith_of_the_void	The Monolith of the Void	false
regions_onscreen_wh3_main_chaos_region_the_palace_of_ruin	The Palace of Ruin	false
regions_onscreen_wh3_main_chaos_region_the_red_abyss	The Red Abyss	false
regions_onscreen_wh3_main_chaos_region_the_sea_of_dread	The Sea of Dread	false
regions_onscreen_wh3_main_chaos_region_the_sentinels	The Sentinels	false
regions_onscreen_wh3_main_chaos_region_the_shifting_monolith	The Shifting Monolith	false
regions_onscreen_wh3_main_chaos_region_the_silver_pinnacle	The Silver Pinnacle	false
regions_onscreen_wh3_main_chaos_region_the_silvered_tower_of_sorcerers	The Silvered Tower of Sorcerers	false
regions_onscreen_wh3_main_chaos_region_the_sky_monolith	The Sky Monolith	false
regions_onscreen_wh3_main_chaos_region_the_sunken_sewers	The Sunken Sewers	false
regions_onscreen_wh3_main_chaos_region_the_tower_of_flies	The Tower of Flies	false
regions_onscreen_wh3_main_chaos_region_the_tower_of_gorgoth	The Tower of Gorgoth	false
regions_onscreen_wh3_main_chaos_region_the_tower_of_khrakk	The Tower of Khrakk	false
regions_onscreen_wh3_main_chaos_region_the_tower_of_torment	The Tower of Torment	false
regions_onscreen_wh3_main_chaos_region_the_twisted_towers	The Twisted Towers	false
regions_onscreen_wh3_main_chaos_region_the_vale_of_nightmares	The Vale of Nightmares	false
regions_onscreen_wh3_main_chaos_region_the_volary	The Volary	false
regions_onscreen_wh3_main_chaos_region_the_writhing_fortress	The Writhing Fortress	false
regions_onscreen_wh3_main_chaos_region_titans_notch	Titan's Notch	false
regions_onscreen_wh3_main_chaos_region_tower_of_ashshair	Tower of Ashshair	false
regions_onscreen_wh3_main_chaos_region_tower_of_grief	Tower of Grief	false
regions_onscreen_wh3_main_chaos_region_tree_of_damned_shades	Tree of Damned Shades	false
regions_onscreen_wh3_main_chaos_region_troll_fjord	Troll Fjord	false
regions_onscreen_wh3_main_chaos_region_turtle_gate	Turtle Gate	false
regions_onscreen_wh3_main_chaos_region_ubersreik	Ubersreik	false
regions_onscreen_wh3_main_chaos_region_uzkulak	Uzkulak	false
regions_onscreen_wh3_main_chaos_region_uzkulany	Uzkulany	false
regions_onscreen_wh3_main_chaos_region_vale_of_titans	Vale of Titans	false
regions_onscreen_wh3_main_chaos_region_village_of_the_moon	Village of the Moon	false
regions_onscreen_wh3_main_chaos_region_village_of_the_tigermen	Village of the Tigermen	false
regions_onscreen_wh3_main_chaos_region_volcanos_heart	Volcano's Heart	false
regions_onscreen_wh3_main_chaos_region_volksgrad	Volksgrad	false
regions_onscreen_wh3_main_chaos_region_waldenhof	Waldenhof	false
regions_onscreen_wh3_main_chaos_region_wei_jin	Wei-Jin	false
regions_onscreen_wh3_main_chaos_region_weng_chang	Weng Chang	false
regions_onscreen_wh3_main_chaos_region_winter_pyre	Winter Pyre	false
regions_onscreen_wh3_main_chaos_region_wolfenburg	Wolfenburg	false
regions_onscreen_wh3_main_chaos_region_wurtbad	Wurtbad	false
regions_onscreen_wh3_main_chaos_region_wurzen	Wurzen	false
regions_onscreen_wh3_main_chaos_region_xen_wu	Xen Wu	false
regions_onscreen_wh3_main_chaos_region_xing_po	Xing Po	false
regions_onscreen_wh3_main_chaos_region_yetchitch	Yetchitch	false
regions_onscreen_wh3_main_chaos_region_yhetee_peak	Yhetee Peak	false
regions_onscreen_wh3_main_chaos_region_zamoski	Zamoski	false
regions_onscreen_wh3_main_chaos_region_zanbaijin	Plains of Zanbaijin	false
regions_onscreen_wh3_main_chaos_region_zerulous	Zerulous	false
regions_onscreen_wh3_main_chaos_region_zhanshi	Zhanshi	false
regions_onscreen_wh3_main_chaos_region_zharr_naggrund	Zharr Naggrund	false
regions_onscreen_wh3_main_chaos_region_zhufbar	Zhufbar	false
regions_onscreen_wh3_main_chaos_region_zoishenk	Zoishenk	false
regions_onscreen_wh3_main_combi_region_aarnau	Aarnau	false
regions_onscreen_wh3_main_combi_region_agrul_migdhal	Agrul Migdhal	false
regions_onscreen_wh3_main_combi_region_akendorf	Akendorf	false
regions_onscreen_wh3_main_combi_region_al_haikk	Al Haikk	false
regions_onscreen_wh3_main_combi_region_altar_of_facades	Altar of Facades	false
regions_onscreen_wh3_main_combi_region_altar_of_spawns	Altar of Spawns	false
regions_onscreen_wh3_main_combi_region_altar_of_the_crimson_harvest	Altar of the Crimson Harvest	false
regions_onscreen_wh3_main_combi_region_altar_of_the_horned_rat	Altar of the Horned Rat	false
regions_onscreen_wh3_main_combi_region_altar_of_ultimate_darkness	Altar of Ultimate Darkness	false
regions_onscreen_wh3_main_combi_region_altdorf	Altdorf	false
regions_onscreen_wh3_main_combi_region_amblepeak	Amblepeak	false
regions_onscreen_wh3_main_combi_region_ancient_city_of_quintex	Ancient City of Quintex	false
regions_onscreen_wh3_main_combi_region_angerrial	Angerrial	false
regions_onscreen_wh3_main_combi_region_antoch	Antoch	false
regions_onscreen_wh3_main_combi_region_aquitaine	Aquitaine	false
regions_onscreen_wh3_main_combi_region_argalis	Argalis	false
regions_onscreen_wh3_main_combi_region_arnheim	Arnheim	false
regions_onscreen_wh3_main_combi_region_ash_ridge_mountains	Ash Ridge Mountains	false
regions_onscreen_wh3_main_combi_region_ashrak	Ashrak	false
regions_onscreen_wh3_main_combi_region_averheim	Averheim	false
regions_onscreen_wh3_main_combi_region_avethir	Avethir	false
regions_onscreen_wh3_main_combi_region_axlotl	Axlotl	false
regions_onscreen_wh3_main_combi_region_baleful_hills	Baleful Hills	false
regions_onscreen_wh3_main_combi_region_bamboo_crossing	Bamboo Crossing	false
regions_onscreen_wh3_main_combi_region_barag_dawazbag	Barag Dawazbag	false
regions_onscreen_wh3_main_combi_region_barak_varr	Barak Varr	false
regions_onscreen_wh3_main_combi_region_bay_of_blades	Bay of Blades	false
regions_onscreen_wh3_main_combi_region_bechafen	Bechafen	false
regions_onscreen_wh3_main_combi_region_beichai	Beichai	false
regions_onscreen_wh3_main_combi_region_bhagar	Bhagar	false
regions_onscreen_wh3_main_combi_region_bilbali	Bilbali	false
regions_onscreen_wh3_main_combi_region_bilious_cliffs	Bilious Cliffs	false
regions_onscreen_wh3_main_combi_region_bitter_bay	Bitter Bay	false
regions_onscreen_wh3_main_combi_region_bitterstone_mine	Bitterstone Mine	false
regions_onscreen_wh3_main_combi_region_black_crag	Black Crag	false
regions_onscreen_wh3_main_combi_region_black_creek_spire	Black Creek Spire	false
regions_onscreen_wh3_main_combi_region_black_fang	Black Fang	false
regions_onscreen_wh3_main_combi_region_black_fortress	Black Fortress	false
regions_onscreen_wh3_main_combi_region_black_iron_mine	Black Iron Mine	false
regions_onscreen_wh3_main_combi_region_black_pyramid_of_nagash	Black Pyramid of Nagash	false
regions_onscreen_wh3_main_combi_region_black_rock	Black Rock	false
regions_onscreen_wh3_main_combi_region_black_tower_of_arkhan	Black Tower of Arkhan	false
regions_onscreen_wh3_main_combi_region_blacklight_tower	Blacklight Tower	false
regions_onscreen_wh3_main_combi_region_blackstone_post	Blackstone Post	false
regions_onscreen_wh3_main_combi_region_bleak_hold_fortress	Bleak Hold Fortress	false
regions_onscreen_wh3_main_combi_region_blizzardpeak	Blizzardpeak	false
regions_onscreen_wh3_main_combi_region_blood_mountain	Blood Mountain	false
regions_onscreen_wh3_main_combi_region_bloodpeak	Bloodpeak	false
regions_onscreen_wh3_main_combi_region_bloodwind_keep	Bloodwind Keep	false
regions_onscreen_wh3_main_combi_region_blue_river	Blue River	false
regions_onscreen_wh3_main_combi_region_bordeleaux	Bordeleaux	false
regions_onscreen_wh3_main_combi_region_brass_keep	Brass Keep	false
regions_onscreen_wh3_main_combi_region_bridge_of_heaven	Bridge of Heaven	false
regions_onscreen_wh3_main_combi_region_brionne	Brionne	false
regions_onscreen_wh3_main_combi_region_cairn_thel	Cairn Thel	false
regions_onscreen_wh3_main_combi_region_carroburg	Carroburg	false
regions_onscreen_wh3_main_combi_region_castle_alexandronov	Castle Alexandronov	false
regions_onscreen_wh3_main_combi_region_castle_artois	Castle Artois	false
regions_onscreen_wh3_main_combi_region_castle_bastonne	Castle Bastonne	false
regions_onscreen_wh3_main_combi_region_castle_carcassonne	Castle Carcassonne	false
regions_onscreen_wh3_main_combi_region_castle_drakenhof	Castle Drakenhof	false
regions_onscreen_wh3_main_combi_region_castle_of_splendour	Castle of Splendour	false
regions_onscreen_wh3_main_combi_region_castle_templehof	Castle Templehof	false
regions_onscreen_wh3_main_combi_region_castle_von_rauken	Castle von Rauken	false
regions_onscreen_wh3_main_combi_region_caverns_of_sotek	Caverns of Sotek	false
regions_onscreen_wh3_main_combi_region_celestial_lake	Celestial Lake	false
regions_onscreen_wh3_main_combi_region_celestial_monastery	Celestial Monastery	false
regions_onscreen_wh3_main_combi_region_chamber_of_visions	Chamber of Visions	false
regions_onscreen_wh3_main_combi_region_chaos_wasteland	Chaos Wasteland	false
regions_onscreen_wh3_main_combi_region_chaqua	Chaqua	false
regions_onscreen_wh3_main_combi_region_chill_road	The Chill Road	false
regions_onscreen_wh3_main_combi_region_chimai	Chimai	false
regions_onscreen_wh3_main_combi_region_chupayotl	Chupayotl	false
regions_onscreen_wh3_main_combi_region_circle_of_destruction	Circle of Destruction	false
regions_onscreen_wh3_main_combi_region_citadel_of_dusk	Citadel of Dusk	false
regions_onscreen_wh3_main_combi_region_citadel_of_lead	Citadel of Lead	false
regions_onscreen_wh3_main_combi_region_city_of_the_shugengan	City of the Shugengan	false
regions_onscreen_wh3_main_combi_region_clar_karond	Clar Karond	false
regions_onscreen_wh3_main_combi_region_clarak_spire	Clarak Spire	false
regions_onscreen_wh3_main_combi_region_cliff_of_beasts	Cliff of Beasts	false
regions_onscreen_wh3_main_combi_region_copher	Copher	false
regions_onscreen_wh3_main_combi_region_couronne	Couronne	false
regions_onscreen_wh3_main_combi_region_crag_halls_of_findol	Crag Halls of Findol	false
regions_onscreen_wh3_main_combi_region_cragroth_deep	Cragroth Deep	false
regions_onscreen_wh3_main_combi_region_crookback_mountain	Crookback Mountain	false
regions_onscreen_wh3_main_combi_region_crooked_fang_fort	Crooked Fang Fort	false
regions_onscreen_wh3_main_combi_region_crucible_of_delights	Crucible of Delights	false
regions_onscreen_wh3_main_combi_region_cuexotl	Cuexotl	false
regions_onscreen_wh3_main_combi_region_daemons_gate	Daemon's Gate	false
regions_onscreen_wh3_main_combi_region_daemons_landing	Daemon's Landing	false
regions_onscreen_wh3_main_combi_region_dagraks_end	Dagrak's End	false
regions_onscreen_wh3_main_combi_region_dai_cheng	Dai Cheng	false
regions_onscreen_wh3_main_combi_region_dargoth	Dargoth	false
regions_onscreen_wh3_main_combi_region_darkhold	Darkhold	false
regions_onscreen_wh3_main_combi_region_dawns_light	Dawn's Light	false
regions_onscreen_wh3_main_combi_region_deaths_head_monoliths	Dead-Head Monoliths	false
regions_onscreen_wh3_main_combi_region_deff_gorge	Deff Gorge	false
regions_onscreen_wh3_main_combi_region_desolation_of_drakenmoor	Desolation of Drakenmoor	false
regions_onscreen_wh3_main_combi_region_desolation_of_nagash	Desolation of Nagash	false
regions_onscreen_wh3_main_combi_region_dietershafen	Dietershafen	false
regions_onscreen_wh3_main_combi_region_dok_karaz	Dok Karaz	false
regions_onscreen_wh3_main_combi_region_doom_glade	Doom Glade	false
regions_onscreen_wh3_main_combi_region_doomkeep	Doomkeep	false
regions_onscreen_wh3_main_combi_region_dotternbach	Dotternbach	false
regions_onscreen_wh3_main_combi_region_drackla_spire	Drackla Spire	false
regions_onscreen_wh3_main_combi_region_dragon_fang_mount	Dragon Fang Mount	false
regions_onscreen_wh3_main_combi_region_dragon_gate	Dragon Gate	false
regions_onscreen_wh3_main_combi_region_dragonhorn_mines	Dragonhorn Mines	false
regions_onscreen_wh3_main_combi_region_dragons_crossroad	Dragon's Crossroad	false
regions_onscreen_wh3_main_combi_region_dread_rock	Dread Rock	false
regions_onscreen_wh3_main_combi_region_dringorackaz	Dringorackaz	false
regions_onscreen_wh3_main_combi_region_dusk_peaks	Dusk Peaks	false
regions_onscreen_wh3_main_combi_region_eagle_eyries	Eagle Eyries	false
regions_onscreen_wh3_main_combi_region_eagle_gate	Eagle Gate	false
regions_onscreen_wh3_main_combi_region_eastern_sea_of_dread	Eastern Sea of Dread	false
regions_onscreen_wh3_main_combi_region_eilhart	Eilhart	false
regions_onscreen_wh3_main_combi_region_ekrund	Ekrund	false
regions_onscreen_wh3_main_combi_region_el_kalabad	El-Kalabad	false
regions_onscreen_wh3_main_combi_region_eldar_spire	Eldar Spire	false
regions_onscreen_wh3_main_combi_region_elessaeli	Elessaeli	false
regions_onscreen_wh3_main_combi_region_elisia	Elisia	false
regions_onscreen_wh3_main_combi_region_erengrad	Erengrad	false
regions_onscreen_wh3_main_combi_region_eschen	Eschen	false
regions_onscreen_wh3_main_combi_region_essen	Essen	false
regions_onscreen_wh3_main_combi_region_evershale	Evershale	false
regions_onscreen_wh3_main_combi_region_eye_of_the_panther	Eye of the Panther	false
regions_onscreen_wh3_main_combi_region_fallen_gates	Fallen Gates	false
regions_onscreen_wh3_main_combi_region_fallen_king_mountain	Fallen King Mountain	false
regions_onscreen_wh3_main_combi_region_fateweavers_crevasse	Fateweaver's Crevasse	false
regions_onscreen_wh3_main_combi_region_fire_mouth	Fire Mouth	false
regions_onscreen_wh3_main_combi_region_flayed_rock	Flayed Rock	false
regions_onscreen_wh3_main_combi_region_flensburg	Flensburg	false
regions_onscreen_wh3_main_combi_region_floating_mountain	Floating Mountain	false
regions_onscreen_wh3_main_combi_region_floating_pyramid	Floating Pyramid	false
regions_onscreen_wh3_main_combi_region_floating_village	Floating Village	false
regions_onscreen_wh3_main_combi_region_forest_of_arnheim	Forest of Arnheim	false
regions_onscreen_wh3_main_combi_region_forest_of_gloom	Forest of Gloom	false
regions_onscreen_wh3_main_combi_region_fort_bergbres	Fort Bergbres	false
regions_onscreen_wh3_main_combi_region_fort_jakova	Fort Jakova	false
regions_onscreen_wh3_main_combi_region_fort_oberstyre	Fort Oberstyre	false
regions_onscreen_wh3_main_combi_region_fort_ostrosk	Fort Ostrosk	false
regions_onscreen_wh3_main_combi_region_fort_soll	Fort Soll	false
regions_onscreen_wh3_main_combi_region_fort_straghov	Fort Straghov	false
regions_onscreen_wh3_main_combi_region_fortress_of_dawn	Fortress of Dawn	false
regions_onscreen_wh3_main_combi_region_fortress_of_eyes	Fortress of Eyes	false
regions_onscreen_wh3_main_combi_region_fortress_of_the_damned	Fortress of the Damned	false
regions_onscreen_wh3_main_combi_region_foundry_of_bones	Foundry of Bones	false
regions_onscreen_wh3_main_combi_region_frozen_landing	Frozen Landing	false
regions_onscreen_wh3_main_combi_region_frozen_sea	Frozen Sea	false
regions_onscreen_wh3_main_combi_region_fu_chow	Fu-Chow	false
regions_onscreen_wh3_main_combi_region_fu_hung	Fu Hung	false
regions_onscreen_wh3_main_combi_region_fuming_serpent	Fuming Serpent	false
regions_onscreen_wh3_main_combi_region_fyrus	Fyrus	false
regions_onscreen_wh3_main_combi_region_gaean_vale	Gaean Vale	false
regions_onscreen_wh3_main_combi_region_galbaraz	Galbaraz	false
regions_onscreen_wh3_main_combi_region_ghrond	Ghrond	false
regions_onscreen_wh3_main_combi_region_gisoreux	Gisoreux	false
regions_onscreen_wh3_main_combi_region_gnashraks_lair	Gnashrak's Lair	false
regions_onscreen_wh3_main_combi_region_gnobbly_gorge	Gnobbly Gorge	false
regions_onscreen_wh3_main_combi_region_golden_ziggurat	Golden Ziggurat	false
regions_onscreen_wh3_main_combi_region_gor_gazan	Gor Gazan	false
regions_onscreen_wh3_main_combi_region_gorger_rock	Gorger Rock	false
regions_onscreen_wh3_main_combi_region_gorssel	Gorssel	false
regions_onscreen_wh3_main_combi_region_graeling_moot	Graeling Moot	false
regions_onscreen_wh3_main_combi_region_granite_massif	Granite Massif	false
regions_onscreen_wh3_main_combi_region_granite_spikes	Granite Spikes	false
regions_onscreen_wh3_main_combi_region_great_canal	Great Canal	false
regions_onscreen_wh3_main_combi_region_great_desert_of_araby	Great Desert of Araby	false
regions_onscreen_wh3_main_combi_region_great_hall_of_greasus	Great Hall of Greasus	false
regions_onscreen_wh3_main_combi_region_great_river	Great River	false
regions_onscreen_wh3_main_combi_region_great_skull_lakes	Great Skull Lakes	false
regions_onscreen_wh3_main_combi_region_great_turtle_isle	Great Turtle Isle	false
regions_onscreen_wh3_main_combi_region_grenzstadt	Grenzstadt	false
regions_onscreen_wh3_main_combi_region_grey_rock_point	Grey Rock Point	false
regions_onscreen_wh3_main_combi_region_griffon_gate	Griffon Gate	false
regions_onscreen_wh3_main_combi_region_grimhold	Grimhold	false
regions_onscreen_wh3_main_combi_region_grimtop	Grimtop	false
regions_onscreen_wh3_main_combi_region_gristle_valley	Gristle Valley	false
regions_onscreen_wh3_main_combi_region_grom_peak	Grom Peak	false
regions_onscreen_wh3_main_combi_region_gronti_mingol	Gronti Mingol	false
regions_onscreen_wh3_main_combi_region_grotrilexs_glare_lighthouse	Grotrilex's Glare Lighthouse	false
regions_onscreen_wh3_main_combi_region_grunburg	Grunburg	false
regions_onscreen_wh3_main_combi_region_grung_zint	Grung Zint	false
regions_onscreen_wh3_main_combi_region_gryphon_wood	Gryphon Wood	false
regions_onscreen_wh3_main_combi_region_gulf_of_kislev	Gulf of Kislev	false
regions_onscreen_wh3_main_combi_region_gulf_of_medes	Gulf of Medes	false
regions_onscreen_wh3_main_combi_region_hag_graef	Hag Graef	false
regions_onscreen_wh3_main_combi_region_hag_hall	Hag Hall	false
regions_onscreen_wh3_main_combi_region_haichai	Haichai	false
regions_onscreen_wh3_main_combi_region_hanyu_port	Hanyu Port	false
regions_onscreen_wh3_main_combi_region_har_ganeth	Har Ganeth	false
regions_onscreen_wh3_main_combi_region_har_kaldra	Har Kaldra	false
regions_onscreen_wh3_main_combi_region_hell_pit	Hell Pit	false
regions_onscreen_wh3_main_combi_region_helmgart	Helmgart	false
regions_onscreen_wh3_main_combi_region_hergig	Hergig	false
regions_onscreen_wh3_main_combi_region_hexoatl	Hexoatl	false
regions_onscreen_wh3_main_combi_region_hoteks_column	Hotek's Column	false
regions_onscreen_wh3_main_combi_region_howling_rock	Howling Rock	false
regions_onscreen_wh3_main_combi_region_hualotal	Hualotal	false
regions_onscreen_wh3_main_combi_region_ice_rock_gorge	Ice Rock Gorge	false
regions_onscreen_wh3_main_combi_region_icespewer	Icespewer	false
regions_onscreen_wh3_main_combi_region_infernius	Infernius	false
regions_onscreen_wh3_main_combi_region_iron_rock	Iron Rock	false
regions_onscreen_wh3_main_combi_region_iron_storm	Iron Storm	false
regions_onscreen_wh3_main_combi_region_ironfrost	Ironfrost	false
regions_onscreen_wh3_main_combi_region_ironspike	Ironspike	false
regions_onscreen_wh3_main_combi_region_isle_of_wights	Isle of Wights	false
regions_onscreen_wh3_main_combi_region_itza	Itza	false
regions_onscreen_wh3_main_combi_region_jade_river	Jade River	false
regions_onscreen_wh3_main_combi_region_jade_wind_mountain	Jade Wind Mountain	false
regions_onscreen_wh3_main_combi_region_jungles_of_chian	Jungles of Chi'an	false
regions_onscreen_wh3_main_combi_region_ka_sabar	Ka-Sabar	false
regions_onscreen_wh3_main_combi_region_kaiax	Kaiax	false
regions_onscreen_wh3_main_combi_region_kappelburg	Kappelburg	false
regions_onscreen_wh3_main_combi_region_karag_dromar	Karag Dromar	false
regions_onscreen_wh3_main_combi_region_karag_dron	Karag Dron	false
regions_onscreen_wh3_main_combi_region_karag_orrud	Karag Orrud	false
regions_onscreen_wh3_main_combi_region_karak_angazhar	Karak Angazhar	false
regions_onscreen_wh3_main_combi_region_karak_azgal	Karak Azgal	false
regions_onscreen_wh3_main_combi_region_karak_azgaraz	Karak Azgaraz	false
regions_onscreen_wh3_main_combi_region_karak_azorn	Karak Azorn	false
regions_onscreen_wh3_main_combi_region_karak_azul	Karak Azul	false
regions_onscreen_wh3_main_combi_region_karak_bhufdar	Karak Bhufdar	false
regions_onscreen_wh3_main_combi_region_karak_dum	Karak Dum	false
regions_onscreen_wh3_main_combi_region_karak_eight_peaks	Karak Eight Peaks	false
regions_onscreen_wh3_main_combi_region_karak_hirn	Karak Hirn	false
regions_onscreen_wh3_main_combi_region_karak_izor	Karak Izor	false
regions_onscreen_wh3_main_combi_region_karak_kadrin	Karak Kadrin	false
regions_onscreen_wh3_main_combi_region_karak_krakaten	Karak Krakaten	false
regions_onscreen_wh3_main_combi_region_karak_norn	Karak Norn	false
regions_onscreen_wh3_main_combi_region_karak_raziak	Karak Raziak	false
regions_onscreen_wh3_main_combi_region_karak_ungor	Karak Ungor	false
regions_onscreen_wh3_main_combi_region_karak_vlag	Karak Vlag	false
regions_onscreen_wh3_main_combi_region_karak_vrag	Karak Vrag	false
regions_onscreen_wh3_main_combi_region_karak_ziflin	Karak Ziflin	false
regions_onscreen_wh3_main_combi_region_karak_zorn	Karak Zorn	false
regions_onscreen_wh3_main_combi_region_karaz_a_karak	Karaz-a-Karak	false
regions_onscreen_wh3_main_combi_region_karond_kar	Karond Kar	false
regions_onscreen_wh3_main_combi_region_kauark	Kauark	false
regions_onscreen_wh3_main_combi_region_kemperbad	Kemperbad	false
regions_onscreen_wh3_main_combi_region_khazid_bordkarag	Lair of the Troll King	false
regions_onscreen_wh3_main_combi_region_khazid_irkulaz	Khazid Irkulaz	false
regions_onscreen_wh3_main_combi_region_khemri	Khemri	false
regions_onscreen_wh3_main_combi_region_khymerica_spire	Khymerica Spire	false
regions_onscreen_wh3_main_combi_region_kings_glade	King's Glade	false
regions_onscreen_wh3_main_combi_region_kislev	Kislev	false
regions_onscreen_wh3_main_combi_region_konquata	Konquata	false
regions_onscreen_wh3_main_combi_region_kradtommen	Kradtommen	false
regions_onscreen_wh3_main_combi_region_kraka_drak	Kraka Drak	false
regions_onscreen_wh3_main_combi_region_kraken_sea	Kraken Sea	false
regions_onscreen_wh3_main_combi_region_krugenheim	Krugenheim	false
regions_onscreen_wh3_main_combi_region_kunlan	Kunlan	false
regions_onscreen_wh3_main_combi_region_lahmia	Lahmia	false
regions_onscreen_wh3_main_combi_region_lake	Lake	false
regions_onscreen_wh3_main_combi_region_languille	L'Anguille	false
regions_onscreen_wh3_main_combi_region_lashiek	Lashiek	false
regions_onscreen_wh3_main_combi_region_laurelorn_forest	Laurelorn Forest	false
regions_onscreen_wh3_main_combi_region_li_temple	Li Temple	false
regions_onscreen_wh3_main_combi_region_li_zhu	Li Zhu	false
regions_onscreen_wh3_main_combi_region_lizard_sea	Lizard Sea	false
regions_onscreen_wh3_main_combi_region_longship_graveyard	Longship Graveyard	false
regions_onscreen_wh3_main_combi_region_lost_plateau	Lost Plateau	false
regions_onscreen_wh3_main_combi_region_lothern	Lothern	false
regions_onscreen_wh3_main_combi_region_luccini	Luccini	false
regions_onscreen_wh3_main_combi_region_lybaras	Lybaras	false
regions_onscreen_wh3_main_combi_region_lyonesse	Lyonesse	false
regions_onscreen_wh3_main_combi_region_macu_peaks	Macu Peaks	false
regions_onscreen_wh3_main_combi_region_magritta	Magritta	false
regions_onscreen_wh3_main_combi_region_mahrak	Mahrak	false
regions_onscreen_wh3_main_combi_region_mangrove_coast	Mangrove Coast	false
regions_onscreen_wh3_main_combi_region_mangrove_coast_sea	Mangrove Coast	false
regions_onscreen_wh3_main_combi_region_marienburg	Marienburg	false
regions_onscreen_wh3_main_combi_region_marks_of_the_old_ones	Marks of the Old Ones	false
regions_onscreen_wh3_main_combi_region_martek	Martek	false
regions_onscreen_wh3_main_combi_region_massif_orcal	Massif Orcal	false
regions_onscreen_wh3_main_combi_region_matorca	Matorca	false
regions_onscreen_wh3_main_combi_region_middenheim	Middenheim	false
regions_onscreen_wh3_main_combi_region_middenstag	Middenstag	false
regions_onscreen_wh3_main_combi_region_middle_sea	Middle Sea	false
regions_onscreen_wh3_main_combi_region_mighdal_vongalbarak	Mighdal Vongalbarak	false
regions_onscreen_wh3_main_combi_region_mine_of_the_bearded_skulls	Mine of the Bearded Skulls	false
regions_onscreen_wh3_main_combi_region_ming_zhu	Ming Zhu	false
regions_onscreen_wh3_main_combi_region_miragliano	Miragliano	false
regions_onscreen_wh3_main_combi_region_mistnar	Mistnar	false
regions_onscreen_wh3_main_combi_region_misty_mountain	Misty Mountain	false
regions_onscreen_wh3_main_combi_region_monolith_of_borkill_the_bloody_handed	Monolith of Borkill the Bloody-Handed	false
regions_onscreen_wh3_main_combi_region_monolith_of_bubonicus	Monolith of Bubonicus	false
regions_onscreen_wh3_main_combi_region_monolith_of_festerlung	Monolith of Festerlung	false
regions_onscreen_wh3_main_combi_region_monolith_of_flesh	The Monolith of Flesh	false
regions_onscreen_wh3_main_combi_region_montenas	Montenas	false
regions_onscreen_wh3_main_combi_region_montfort	Montfort	false
regions_onscreen_wh3_main_combi_region_monument_of_izzatal	Monument of Izzatal	false
regions_onscreen_wh3_main_combi_region_monument_of_the_moon	Monument of the Moon	false
regions_onscreen_wh3_main_combi_region_mordheim	Mordheim	false
regions_onscreen_wh3_main_combi_region_morgheim	Morgheim	false
regions_onscreen_wh3_main_combi_region_mount_arachnos	Mount Arachnos	false
regions_onscreen_wh3_main_combi_region_mount_athull	Mount Athull	false
regions_onscreen_wh3_main_combi_region_mount_grey_hag	Mount Grey Hag	false
regions_onscreen_wh3_main_combi_region_mount_gunbad	Mount Gunbad	false
regions_onscreen_wh3_main_combi_region_mount_silverspear	Mount Silverspear	false
regions_onscreen_wh3_main_combi_region_mount_squighorn	Mount Squighorn	false
regions_onscreen_wh3_main_combi_region_mount_thug	Mount Thug	false
regions_onscreen_wh3_main_combi_region_mousillon	Mousillon	false
regions_onscreen_wh3_main_combi_region_myrmidens	Myrmidens	false
regions_onscreen_wh3_main_combi_region_nagashizzar	Nagashizzar	false
regions_onscreen_wh3_main_combi_region_nagenhof	Nagenhof	false
regions_onscreen_wh3_main_combi_region_naggarond	Naggarond	false
regions_onscreen_wh3_main_combi_region_naglfari_plain	Naglfari Plain	false
regions_onscreen_wh3_main_combi_region_nagrar	Nagrar	false
regions_onscreen_wh3_main_combi_region_nahuontl	Nahuontl	false
regions_onscreen_wh3_main_combi_region_nan_gau	Nan-Gau	false
regions_onscreen_wh3_main_combi_region_nan_li	Nan-Li	false
regions_onscreen_wh3_main_combi_region_niedling	Niedling	false
regions_onscreen_wh3_main_combi_region_nonchang	Nongchang	false
regions_onscreen_wh3_main_combi_region_norden	Norden	false
regions_onscreen_wh3_main_combi_region_northern_sea_of_chaos	Northern Sea of Chaos	false
regions_onscreen_wh3_main_combi_region_northern_straits_of_the_great_ocean	Northern Straits of the Great Ocean	false
regions_onscreen_wh3_main_combi_region_northern_straits_of_the_jade_sea	Northern Straits of the Jade Sea	false
regions_onscreen_wh3_main_combi_region_novchozy	Novchozy	false
regions_onscreen_wh3_main_combi_region_nuja	Nuja	false
regions_onscreen_wh3_main_combi_region_nuln	Nuln	false
regions_onscreen_wh3_main_combi_region_numas	Numas	false
regions_onscreen_wh3_main_combi_region_oakenhammer	Oakenhammer	false
regions_onscreen_wh3_main_combi_region_okkams_forever_maze	Okkam's Forever Maze	false
regions_onscreen_wh3_main_combi_region_oreons_camp	Oreon's Camp	false
regions_onscreen_wh3_main_combi_region_oyxl	Oyxl	false
regions_onscreen_wh3_main_combi_region_pack_ice_bay	Pack Ice Bay	false
regions_onscreen_wh3_main_combi_region_pahuax	Pahuax	false
regions_onscreen_wh3_main_combi_region_palace_of_princes	Palace of Princes	false
regions_onscreen_wh3_main_combi_region_parravon	Parravon	false
regions_onscreen_wh3_main_combi_region_petrified_forest	Petrified Forest	false
regions_onscreen_wh3_main_combi_region_pfeildorf	Pfeildorf	false
regions_onscreen_wh3_main_combi_region_phoenix_gate	Phoenix Gate	false
regions_onscreen_wh3_main_combi_region_pigbarter	Pigbarter	false
regions_onscreen_wh3_main_combi_region_pillar_of_skulls	Pillar of Skulls	false
regions_onscreen_wh3_main_combi_region_pillars_of_unseen_constellations	Pillars of Unseen Constellations	false
regions_onscreen_wh3_main_combi_region_plain_of_dogs	Plain of Dogs	false
regions_onscreen_wh3_main_combi_region_plain_of_spiders	Plain of Spiders	false
regions_onscreen_wh3_main_combi_region_plain_of_tuskers	Plain of Tuskers	false
regions_onscreen_wh3_main_combi_region_po_mei	Po Mei	false
regions_onscreen_wh3_main_combi_region_pools_of_despair	Pools of Despair	false
regions_onscreen_wh3_main_combi_region_port_elistor	Port Elistor	false
regions_onscreen_wh3_main_combi_region_port_of_secrets	Port of Secrets	false
regions_onscreen_wh3_main_combi_region_port_reaver	Port Reaver	false
regions_onscreen_wh3_main_combi_region_pox_marsh	Pox Marsh	false
regions_onscreen_wh3_main_combi_region_praag	Praag	false
regions_onscreen_wh3_main_combi_region_qiang	Qiang	false
regions_onscreen_wh3_main_combi_region_quatar	Quatar	false
regions_onscreen_wh3_main_combi_region_quenelles	Quenelles	false
regions_onscreen_wh3_main_combi_region_quetza	Quetza	false
regions_onscreen_wh3_main_combi_region_quittax	Qu'ittax	false
regions_onscreen_wh3_main_combi_region_rackdo_gorge	Rackdo Gorge	false
regions_onscreen_wh3_main_combi_region_rasetra	Rasetra	false
regions_onscreen_wh3_main_combi_region_red_fortress	Red Fortress	false
regions_onscreen_wh3_main_combi_region_red_river	Red River	false
regions_onscreen_wh3_main_combi_region_riffraffa	Riffraffa	false
regions_onscreen_wh3_main_combi_region_river_reik	River Reik	false
regions_onscreen_wh3_main_combi_region_rothkar_spire	Rothkar Spire	false
regions_onscreen_wh3_main_combi_region_ruins_end	Ruin's End	false
regions_onscreen_wh3_main_combi_region_sabre_mountain	Sabre Mountain	false
regions_onscreen_wh3_main_combi_region_salzenmund	Salzenmund	false
regions_onscreen_wh3_main_combi_region_sarl_encampment	Sarl Encampment	false
regions_onscreen_wh3_main_combi_region_sartosa	Sartosa	false
regions_onscreen_wh3_main_combi_region_scarpels_lair	Scarpel's Lair	false
regions_onscreen_wh3_main_combi_region_scorpion_coast	Scorpion Coast	false
regions_onscreen_wh3_main_combi_region_sea_of_chill	Sea of Chill	false
regions_onscreen_wh3_main_combi_region_sea_of_claws	Sea of Claws	false
regions_onscreen_wh3_main_combi_region_sea_of_malice	Sea of Malice	false
regions_onscreen_wh3_main_combi_region_sea_of_serpents	Sea of Serpents	false
regions_onscreen_wh3_main_combi_region_sea_of_squalls	Sea of Squalls	false
regions_onscreen_wh3_main_combi_region_sea_of_storms	Sea of Storms	false
regions_onscreen_wh3_main_combi_region_sentinels_of_xeti	Sentinels of Xeti	false
regions_onscreen_wh3_main_combi_region_serpent_coast	Serpent Coast	false
regions_onscreen_wh3_main_combi_region_serpent_coast_sea	Serpent Coast	false
regions_onscreen_wh3_main_combi_region_serpent_jetty	Serpent Jetty	false
regions_onscreen_wh3_main_combi_region_serpent_river	Serpent River	false
regions_onscreen_wh3_main_combi_region_shagrath	Shagrath	false
regions_onscreen_wh3_main_combi_region_shang_wu	Shang-Wu	false
regions_onscreen_wh3_main_combi_region_shang_yang	Shang-Yang	false
regions_onscreen_wh3_main_combi_region_shard_bastion	Shard Bastion	false
regions_onscreen_wh3_main_combi_region_shark_straights	Shark Straits	false
regions_onscreen_wh3_main_combi_region_shattered_cove	Shattered Stone Bay	false
regions_onscreen_wh3_main_combi_region_shattered_stone_isle	Shattered Stone Isle	false
regions_onscreen_wh3_main_combi_region_shi_long	Shi Long	false
regions_onscreen_wh3_main_combi_region_shi_wu	Shi-Wu	false
regions_onscreen_wh3_main_combi_region_shifting_isles	Shifting Isles	false
regions_onscreen_wh3_main_combi_region_shifting_mangrove_coastline	Shifting Mangrove Coastline	false
regions_onscreen_wh3_main_combi_region_shiyamas_rest	Shiyama's Rest	false
regions_onscreen_wh3_main_combi_region_shrine_of_asuryan	Shrine of Asuryan	false
regions_onscreen_wh3_main_combi_region_shrine_of_khaine	Shrine of Khaine	false
regions_onscreen_wh3_main_combi_region_shrine_of_kurnous	Shrine of Kurnous	false
regions_onscreen_wh3_main_combi_region_shrine_of_ladrielle	Shrine of Ladrielle	false
regions_onscreen_wh3_main_combi_region_shrine_of_loec	Shrine of Loec	false
regions_onscreen_wh3_main_combi_region_shrine_of_sotek	Shrine of Sotek	false
regions_onscreen_wh3_main_combi_region_shrine_of_the_alchemist	Shrine of the Alchemist	false
regions_onscreen_wh3_main_combi_region_shroktak_mount	Shroktak Mount	false
regions_onscreen_wh3_main_combi_region_silver_pinnacle	Silver Pinnacle	false
regions_onscreen_wh3_main_combi_region_sjoktraken	Sjoktraken	false
regions_onscreen_wh3_main_combi_region_skavenblight	Skavenblight	false
regions_onscreen_wh3_main_combi_region_skeggi	Skeggi	false
regions_onscreen_wh3_main_combi_region_skrap_towers	Skrap Towers	false
regions_onscreen_wh3_main_combi_region_slavers_point	Slaver's Point	false
regions_onscreen_wh3_main_combi_region_snake_gate	Snake Gate	false
regions_onscreen_wh3_main_combi_region_sorcerers_islands	Sorcerers' Islands	false
regions_onscreen_wh3_main_combi_region_soteks_trail	Sotek's Trail	false
regions_onscreen_wh3_main_combi_region_southern_sea_of_chaos	Southern Sea of Chaos	false
regions_onscreen_wh3_main_combi_region_spektazuma	Spektazuma	false
regions_onscreen_wh3_main_combi_region_spite_reach	Spite Reach	false
regions_onscreen_wh3_main_combi_region_spitepeak	Spitepeak	false
regions_onscreen_wh3_main_combi_region_springs_of_eternal_life	Springs of Eternal Life	false
regions_onscreen_wh3_main_combi_region_ssildra_tor	Ss'ildra Tor	false
regions_onscreen_wh3_main_combi_region_statues_of_the_gods	Statues of the Gods	false
regions_onscreen_wh3_main_combi_region_steingart	Steingart	false
regions_onscreen_wh3_main_combi_region_stonemine_tower	Stonemine Tower	false
regions_onscreen_wh3_main_combi_region_storag_kor	Storag Kor	false
regions_onscreen_wh3_main_combi_region_stormhenge	Stormhenge	false
regions_onscreen_wh3_main_combi_region_stormvrack_mount	Stormvrack Mount	false
regions_onscreen_wh3_main_combi_region_straights_of_chaos	Straits of Chaos	false
regions_onscreen_wh3_main_combi_region_straits_of_fear	Straits of Fear	false
regions_onscreen_wh3_main_combi_region_straits_of_lothern	Straits of Lothern	false
regions_onscreen_wh3_main_combi_region_straits_of_nagash	Straits of Nagash	false
regions_onscreen_wh3_main_combi_region_subatuun	Subatuun	false
regions_onscreen_wh3_main_combi_region_sudenburg	Sudenburg	false
regions_onscreen_wh3_main_combi_region_sulpharets	Sulpharets	false
regions_onscreen_wh3_main_combi_region_sump_pit	Death Pit	false
regions_onscreen_wh3_main_combi_region_sun_tree_glades	Sun-Tree Glades	false
regions_onscreen_wh3_main_combi_region_sunken_khernarch	Sunken Khernarch	false
regions_onscreen_wh3_main_combi_region_sunken_lands	Sunken Lands	false
regions_onscreen_wh3_main_combi_region_swamp_town	Swamp Town	false
regions_onscreen_wh3_main_combi_region_swartzhafen	Swartzhafen	false
regions_onscreen_wh3_main_combi_region_tai_tzu	Tai Tzu	false
regions_onscreen_wh3_main_combi_region_talabheim	Talabheim	false
regions_onscreen_wh3_main_combi_region_tarantula_coast	Tarantula Coast	false
regions_onscreen_wh3_main_combi_region_temple_avenue_of_gold	Temple Avenue of Gold	false
regions_onscreen_wh3_main_combi_region_temple_of_addaioth	Temple of Addaioth	false
regions_onscreen_wh3_main_combi_region_temple_of_elemental_winds	Temple of Elemental Winds	false
regions_onscreen_wh3_main_combi_region_temple_of_heimkel	Temple of Heimkel	false
regions_onscreen_wh3_main_combi_region_temple_of_kara	Temple of Kara	false
regions_onscreen_wh3_main_combi_region_temple_of_khaine	Temple of Khaine	false
regions_onscreen_wh3_main_combi_region_temple_of_skulls	Temple of Skulls	false
regions_onscreen_wh3_main_combi_region_temple_of_tlencan	Bregonne	false
regions_onscreen_wh3_main_combi_region_teotiqua	Teotiqua	false
regions_onscreen_wh3_main_combi_region_terracotta_graveyard	Terracotta Graveyard	false
regions_onscreen_wh3_main_combi_region_the_albion_channel	The Albion Channel	false
regions_onscreen_wh3_main_combi_region_the_awakening	The Awakening	false
regions_onscreen_wh3_main_combi_region_the_bitter_sea	The Bitter Sea	false
regions_onscreen_wh3_main_combi_region_the_black_forests	The Black Forests	false
regions_onscreen_wh3_main_combi_region_the_black_gulf	The Black Gulf	false
regions_onscreen_wh3_main_combi_region_the_black_pillar	The Black Pillar	false
regions_onscreen_wh3_main_combi_region_the_black_pit	The Black Pit	false
regions_onscreen_wh3_main_combi_region_the_bleak_coast	The Bleak Sea	false
regions_onscreen_wh3_main_combi_region_the_bleeding_spire	The Bleeding Spire	false
regions_onscreen_wh3_main_combi_region_the_blighted_grove	The Blighted Grove	false
regions_onscreen_wh3_main_combi_region_the_blood_hall	The Blood Hall	false
regions_onscreen_wh3_main_combi_region_the_blood_swamps	The Blood Swamps	false
regions_onscreen_wh3_main_combi_region_the_boiling_sea	The Boiling Sea	false
regions_onscreen_wh3_main_combi_region_the_bone_gulch	The Bone Gulch	false
regions_onscreen_wh3_main_combi_region_the_broken_lands	The Broken Lands	false
regions_onscreen_wh3_main_combi_region_the_burning_monolith	The Burning Monolith	false
regions_onscreen_wh3_main_combi_region_the_challenge_stone	The Challenge Stone	false
regions_onscreen_wh3_main_combi_region_the_churning_gulf	The Churning Gulf	false
regions_onscreen_wh3_main_combi_region_the_copper_landing	The Copper Landing	false
regions_onscreen_wh3_main_combi_region_the_crystal_spires	The Crystal Spires	false
regions_onscreen_wh3_main_combi_region_the_cursed_jungle	The Cursed Jungle	false
regions_onscreen_wh3_main_combi_region_the_daemonium_coast	The Daemonium Coast	false
regions_onscreen_wh3_main_combi_region_the_daemons_stump	The Daemon's Stump	false
regions_onscreen_wh3_main_combi_region_the_dust_gate	The Dust Gate	false
regions_onscreen_wh3_main_combi_region_the_eastern_isles	The Eastern Isles	false
regions_onscreen_wh3_main_combi_region_the_estalia_coastline	The Estalia Coastline	false
regions_onscreen_wh3_main_combi_region_the_falls_of_doom	The Falls of Doom	false
regions_onscreen_wh3_main_combi_region_the_far_sea	The Far Sea	false
regions_onscreen_wh3_main_combi_region_the_fetid_catacombs	The Fetid Catacombs	false
regions_onscreen_wh3_main_combi_region_the_folly_of_malofex	The Folly of Malofex	false
regions_onscreen_wh3_main_combi_region_the_forbidden_citadel	The Forbidden Citadel	false
regions_onscreen_wh3_main_combi_region_the_forbidding_coast	The Forbidding Coast	false
regions_onscreen_wh3_main_combi_region_the_forest_of_decay	The Forest of Decay	false
regions_onscreen_wh3_main_combi_region_the_fortress_of_vorag	The Fortress of Vorag	false
regions_onscreen_wh3_main_combi_region_the_frozen_city	The Frozen City	false
regions_onscreen_wh3_main_combi_region_the_galleons_graveyard	The Galleon's Graveyard	false
regions_onscreen_wh3_main_combi_region_the_galleons_graveyard_sea	The Galleon's Graveyard	false
regions_onscreen_wh3_main_combi_region_the_gallows_tree	The Gallows Tree	false
regions_onscreen_wh3_main_combi_region_the_gates_of_zharr	The Gates of Zharr	false
regions_onscreen_wh3_main_combi_region_the_godless_crater	The Godless Crater	false
regions_onscreen_wh3_main_combi_region_the_golden_colossus	The Golden Colossus	false
regions_onscreen_wh3_main_combi_region_the_golden_tower	The Golden Tower	false
regions_onscreen_wh3_main_combi_region_the_great_arena	The Great Arena	false
regions_onscreen_wh3_main_combi_region_the_great_ocean_north	The Great Ocean	false
regions_onscreen_wh3_main_combi_region_the_great_ocean_south	The Great Ocean	false
regions_onscreen_wh3_main_combi_region_the_haunted_forest	The Haunted Forest	false
regions_onscreen_wh3_main_combi_region_the_high_place	The High Place	false
regions_onscreen_wh3_main_combi_region_the_high_sentinel	The High Sentinel	false
regions_onscreen_wh3_main_combi_region_the_howling_citadel	The Howling Citadel	false
regions_onscreen_wh3_main_combi_region_the_inner_sea	The Inner Sea	false
regions_onscreen_wh3_main_combi_region_the_iron_coast	The Iron Coast	false
regions_onscreen_wh3_main_combi_region_the_isles	The Isles	false
regions_onscreen_wh3_main_combi_region_the_jade_sea	The Jade Sea	false
regions_onscreen_wh3_main_combi_region_the_lost_palace	The Lost Palace	false
regions_onscreen_wh3_main_combi_region_the_lustria_straight	The Lustria Strait	false
regions_onscreen_wh3_main_combi_region_the_maw_gate	The Maw Gate	false
regions_onscreen_wh3_main_combi_region_the_mistnar_crossing	The Mistnar Crossing	false
regions_onscreen_wh3_main_combi_region_the_monolith_of_katam	The Monolith of Katam	false
regions_onscreen_wh3_main_combi_region_the_monoliths	The Monoliths	false
regions_onscreen_wh3_main_combi_region_the_moon_shard	The Moon Shard	false
regions_onscreen_wh3_main_combi_region_the_moot	The Moot	false
regions_onscreen_wh3_main_combi_region_the_never_ending_chasm	The Never-ending Chasm	false
regions_onscreen_wh3_main_combi_region_the_oak_of_ages	The Oak of Ages	false
regions_onscreen_wh3_main_combi_region_the_palace_of_ruin	The Palace of Ruin	false
regions_onscreen_wh3_main_combi_region_the_pillars_of_grungni	The Pillars of Grungni	false
regions_onscreen_wh3_main_combi_region_the_pirate_coast	The Pirate Coast	false
regions_onscreen_wh3_main_combi_region_the_sacred_pools	The Sacred Pools	false
regions_onscreen_wh3_main_combi_region_the_sea_of_dread	The Sea of Dread	false
regions_onscreen_wh3_main_combi_region_the_sentinel_of_time	The Sentinel of Time	false
regions_onscreen_wh3_main_combi_region_the_sentinels	The Sentinels	false
regions_onscreen_wh3_main_combi_region_the_shard_coast	The Shard Coast	false
regions_onscreen_wh3_main_combi_region_the_silvered_tower_of_sorcerers	The Silvered Tower of Sorcerers	false
regions_onscreen_wh3_main_combi_region_the_sinhall_monolith	The Sinhall Monolith	false
regions_onscreen_wh3_main_combi_region_the_skull_carvers_abode	The Skull-Carver's Abode	false
regions_onscreen_wh3_main_combi_region_the_southern_sentinels	The Southern Sentinels	false
regions_onscreen_wh3_main_combi_region_the_southern_straits	The Southern Straits	false
regions_onscreen_wh3_main_combi_region_the_star_tower	The Star Tower	false
regions_onscreen_wh3_main_combi_region_the_tower_of_flies	The Tower of Flies	false
regions_onscreen_wh3_main_combi_region_the_tower_of_khrakk	The Tower of Khrakk	false
regions_onscreen_wh3_main_combi_region_the_tower_of_torment	The Tower of Torment	false
regions_onscreen_wh3_main_combi_region_the_turtle_shallows	The Turtle Shallows	false
regions_onscreen_wh3_main_combi_region_the_twisted_glade	The Twisted Glade	false
regions_onscreen_wh3_main_combi_region_the_twisted_towers	The Twisted Towers	false
regions_onscreen_wh3_main_combi_region_the_vampire_coast_sea	The Vampire Coast	false
regions_onscreen_wh3_main_combi_region_the_volary	The Volary	false
regions_onscreen_wh3_main_combi_region_the_witchwood	The Witchwood	false
regions_onscreen_wh3_main_combi_region_the_writhing_fortress	The Writhing Fortress	false
regions_onscreen_wh3_main_combi_region_thrice_cursed_peak	Thrice-cursed Peak	false
regions_onscreen_wh3_main_combi_region_tilean_sea	Tilean Sea	false
regions_onscreen_wh3_main_combi_region_titans_notch	Titan's Notch	false
regions_onscreen_wh3_main_combi_region_tlanxla	Tlanxla	false
regions_onscreen_wh3_main_combi_region_tlaqua	Tlaqua	false
regions_onscreen_wh3_main_combi_region_tlax	Tlax	false
regions_onscreen_wh3_main_combi_region_tlaxtlan	Tlaxtlan	false
regions_onscreen_wh3_main_combi_region_tobaro	Tobaro	false
regions_onscreen_wh3_main_combi_region_tor_achare	Tor Achare	false
regions_onscreen_wh3_main_combi_region_tor_anlec	Tor Anlec	false
regions_onscreen_wh3_main_combi_region_tor_anroc	Tor Anroc	false
regions_onscreen_wh3_main_combi_region_tor_dranil	Tor Dranil	false
regions_onscreen_wh3_main_combi_region_tor_elasor	Tor Elasor	false
regions_onscreen_wh3_main_combi_region_tor_elyr	Tor Elyr	false
regions_onscreen_wh3_main_combi_region_tor_finu	Tor Finu	false
regions_onscreen_wh3_main_combi_region_tor_koruali	Tor Koruali	false
regions_onscreen_wh3_main_combi_region_tor_saroir	Tor Saroir	false
regions_onscreen_wh3_main_combi_region_tor_sethai	Tor Sethai	false
regions_onscreen_wh3_main_combi_region_tor_surpindar	Tor Surpindar	false
regions_onscreen_wh3_main_combi_region_tor_yvresse	Tor Yvresse	false
regions_onscreen_wh3_main_combi_region_tower_of_ashung	Tower of Ashung	false
regions_onscreen_wh3_main_combi_region_tower_of_gorgoth	Tower of Gorgoth	false
regions_onscreen_wh3_main_combi_region_tower_of_lysean	Tower of Lysean	false
regions_onscreen_wh3_main_combi_region_tower_of_the_stars	Tower of the Stars	false
regions_onscreen_wh3_main_combi_region_tower_of_the_sun	Tower of the Sun	false
regions_onscreen_wh3_main_combi_region_tralinia	Tralinia	false
regions_onscreen_wh3_main_combi_region_tribeslaughter	Tribeslaughter	false
regions_onscreen_wh3_main_combi_region_troll_fjord	Troll Fjord	false
regions_onscreen_wh3_main_combi_region_turtle_gate	Turtle Gate	false
regions_onscreen_wh3_main_combi_region_tyrant_peak	Tyrant Peak	false
regions_onscreen_wh3_main_combi_region_ubersreik	Ubersreik	false
regions_onscreen_wh3_main_combi_region_unicorn_gate	Unicorn Gate	false
regions_onscreen_wh3_main_combi_region_uzkulak	Uzkulak	false
regions_onscreen_wh3_main_combi_region_valayas_sorrow	Valaya's Sorrow	false
regions_onscreen_wh3_main_combi_region_vale_of_titans	Vale of Titans	false
regions_onscreen_wh3_main_combi_region_valley_of_horns	Valley of Horns	false
regions_onscreen_wh3_main_combi_region_varenka_hills	Varenka Hills	false
regions_onscreen_wh3_main_combi_region_varg_camp	Varg Camp	false
regions_onscreen_wh3_main_combi_region_vauls_anvil_loren	Vaul's Anvil	false
regions_onscreen_wh3_main_combi_region_vauls_anvil_naggaroth	Vaul's Anvil	false
regions_onscreen_wh3_main_combi_region_vauls_anvil_ulthuan	Vaul's Anvil	false
regions_onscreen_wh3_main_combi_region_venom_glade	Venom Glade	false
regions_onscreen_wh3_main_combi_region_verdanos	Verdanos	false
regions_onscreen_wh3_main_combi_region_village_of_the_moon	Village of the Moon	false
regions_onscreen_wh3_main_combi_region_village_of_the_tigermen	Village of the Tigermen	false
regions_onscreen_wh3_main_combi_region_vitevo	Vitevo	false
regions_onscreen_wh3_main_combi_region_volcanos_heart	Volcano's Heart	false
regions_onscreen_wh3_main_combi_region_volksgrad	Volksgrad	false
regions_onscreen_wh3_main_combi_region_volulltrax	Volulltrax	false
regions_onscreen_wh3_main_combi_region_vulture_mountain	Vulture Mountain	false
regions_onscreen_wh3_main_combi_region_waili_village	Wai-Li Village	false
regions_onscreen_wh3_main_combi_region_waldenhof	Waldenhof	false
regions_onscreen_wh3_main_combi_region_waterfall_palace	Waterfall Palace	false
regions_onscreen_wh3_main_combi_region_wei_jin	Wei-Jin	false
regions_onscreen_wh3_main_combi_region_weismund	Weismund	false
regions_onscreen_wh3_main_combi_region_wellsprings_of_eternity	Wellsprings of Eternity	false
regions_onscreen_wh3_main_combi_region_weng_chang	Weng Chang	false
regions_onscreen_wh3_main_combi_region_white_tower_of_hoeth	White Tower of Hoeth	false
regions_onscreen_wh3_main_combi_region_whitefire_tor	Whitefire Tor	false
regions_onscreen_wh3_main_combi_region_whitepeak	Whitepeak	false
regions_onscreen_wh3_main_combi_region_winter_pyre	Winter Pyre	false
regions_onscreen_wh3_main_combi_region_wissenburg	Wissenburg	false
regions_onscreen_wh3_main_combi_region_witch_sea	Witch Sea	false
regions_onscreen_wh3_main_combi_region_wizard_caliphs_palace	Wizard Caliph's Palace	false
regions_onscreen_wh3_main_combi_region_wolfenburg	Wolfenburg	false
regions_onscreen_wh3_main_combi_region_worlds_edge_archway	World's Edge Archway	false
regions_onscreen_wh3_main_combi_region_worm_coast	Worm Coast	false
regions_onscreen_wh3_main_combi_region_wreckers_point	Wrecker's Point	false
regions_onscreen_wh3_main_combi_region_wurtbad	Wurtbad	false
regions_onscreen_wh3_main_combi_region_xahutec	Xahutec	false
regions_onscreen_wh3_main_combi_region_xen_wu	Xen Wu	false
regions_onscreen_wh3_main_combi_region_xhotl	Xhotl	false
regions_onscreen_wh3_main_combi_region_xing_po	Xing Po	false
regions_onscreen_wh3_main_combi_region_xlanhuapec	Xlanhuapec	false
regions_onscreen_wh3_main_combi_region_xlanzec	Xlanzec	false
regions_onscreen_wh3_main_combi_region_yetchitch	Yetchitch	false
regions_onscreen_wh3_main_combi_region_yhetee_peak	Yhetee Peak	false
regions_onscreen_wh3_main_combi_region_yuatek	Yuatek	false
regions_onscreen_wh3_main_combi_region_zanbaijin	Zanbaijin	false
regions_onscreen_wh3_main_combi_region_zandri	Zandri	false
regions_onscreen_wh3_main_combi_region_zarakzil	Zarakzil	false
regions_onscreen_wh3_main_combi_region_zavastra	Zavastra	false
regions_onscreen_wh3_main_combi_region_zhanshi	Zhanshi	false
regions_onscreen_wh3_main_combi_region_zharr_naggrund	Zharr Naggrund	false
regions_onscreen_wh3_main_combi_region_zhizhu	Zhi-Zhu	false
regions_onscreen_wh3_main_combi_region_zhufbar	Zhufbar	false
regions_onscreen_wh3_main_combi_region_ziggurat_of_dawn	Ziggurat of Dawn	false
regions_onscreen_wh3_main_combi_region_zlatlan	Zlatlan	false
regions_onscreen_wh3_main_combi_region_zoishenk	Zoishenk	false
regions_onscreen_wh3_main_combi_region_zvorak	Zvorak	false
regions_onscreen_wh3_main_prologue_region_unknown_terrain	Unknown Terrain	false
regions_onscreen_wh3_prologue_region_broken_lands_tong_hall	Tong-Hall	false
regions_onscreen_wh3_prologue_region_canyons_of_gore_gore_town	Gore-Town	false
regions_onscreen_wh3_prologue_region_crimson_vale_hall_of_the_keepers	Hall of the Keepers	false
regions_onscreen_wh3_prologue_region_dervingard_outskirts	Dervingard Outskirts	false
regions_onscreen_wh3_prologue_region_fleshlands_blood_haven	Blood-Haven	false
regions_onscreen_wh3_prologue_region_frozen_plains_dervingard	Dervingard	false
regions_onscreen_wh3_prologue_region_ice_canyon_beacon_fort	Beacon	false
regions_onscreen_wh3_prologue_region_icecaid_pass_claw_reach	Claw Reach	false
regions_onscreen_wh3_prologue_region_kislev_encampment_outskirts	Kislev Refuge Outskirts	false
regions_onscreen_wh3_prologue_region_mirror_marshes_the_loci_palace	The Loci Palace	false
regions_onscreen_wh3_prologue_region_mountain_pass_kislev_refuge	Kislev Refuge	false
regions_onscreen_wh3_prologue_region_plains_of_brass_the_tah_camp	The Tah-Camp	false
regions_onscreen_wh3_prologue_region_river_of_the_flux_the_fording_place	The Fording Place	false
regions_onscreen_wh3_prologue_region_sea	Sea	false
regions_onscreen_wh3_prologue_region_temp_2	Uncanny Mountains	false
regions_onscreen_wh3_prologue_region_temp_3	The Lucent Maze	false
regions_onscreen_wh3_prologue_region_temp_4	The Screaming Chasm	false
regions_onscreen_wh3_prologue_region_temp_5	The Howling Citadel	false
regions_onscreen_wh3_prologue_region_temp_6	Beacon Outskirts	false
regions_onscreen_wh3_prologue_region_the_brazen_lands	The Brazen Lands	false
regions_onscreen_wh3_prologue_region_the_falls_of_circatrex_the_rookery	The Rookery	false
regions_onscreen_wh3_prologue_region_the_maze_keep_mansion_of_eyes	Mansion of Eyes	false
regions_onscreen_wh3_prologue_region_the_scarlet_steppes_the_blood_moot	The Blood-Moot	false
regions_onscreen_wh3_prologue_region_the_void_steppes_the_monolith_of_the_void	The Monolith of the Void	false
regions_onscreen_wh_main_unknown_terrain	Unknown Terrain	false
