key	layout_name
#ui_tooltips_tables;0;db/ui_tooltips_tables/data__	
test_quit_game_tooltip	tooltip_text_and_icon
test_title_list_and_footer_tooltip	tooltip_title_list_and_footer
tooltip_battle_advanced_controls	tooltip_title_and_text
tooltip_battle_advice_history_buttons	tooltip_text_only
tooltip_battle_advisor	tooltip_title_and_text
tooltip_battle_advisor_link	tooltip_text_only
tooltip_battle_ambush_battles	tooltip_title_and_text
tooltip_battle_armies	tooltip_title_and_text
tooltip_battle_armour	tooltip_title_and_text
tooltip_battle_army_abilities	tooltip_title_and_text
tooltip_battle_army_abilities_link	tooltip_text_only
tooltip_battle_army_abilities_panel	tooltip_text_only
tooltip_battle_army_panel	tooltip_text_only
tooltip_battle_artillery	tooltip_title_and_text
tooltip_battle_balance_of_power	tooltip_text_only
tooltip_battle_battle_game	tooltip_title_and_text
tooltip_battle_battle_interface	tooltip_title_and_text
tooltip_battle_battlefield	tooltip_title_and_text
tooltip_battle_blood_for_the_blood_god	tooltip_title_and_text
tooltip_battle_blood_for_the_blood_god_link	tooltip_text_only
tooltip_battle_blood_for_the_blood_god_meter	tooltip_text_only
tooltip_battle_camera_controls	tooltip_title_and_text
tooltip_battle_capture_location_icons	tooltip_text_only
tooltip_battle_capture_locations	tooltip_title_and_text
tooltip_battle_capture_locations_link	tooltip_text_only
tooltip_battle_capture_points	tooltip_title_and_text
tooltip_battle_constructed_defences	tooltip_title_and_text
tooltip_battle_contents	tooltip_text_only
tooltip_battle_deployment	tooltip_title_and_text
tooltip_battle_dragon_transformation	tooltip_title_and_text
tooltip_battle_drop_equipment_button	tooltip_text_only
tooltip_battle_extra_powder	tooltip_title_and_text
tooltip_battle_eye_of_tzeentch	tooltip_title_and_text
tooltip_battle_eye_of_tzeentch_link	tooltip_text_only
tooltip_battle_eye_of_tzeentch_meter	tooltip_text_only
tooltip_battle_fire_at_will	tooltip_title_and_text
tooltip_battle_fire_at_will_button	tooltip_text_only
tooltip_battle_fire_at_will_link	tooltip_text_only
tooltip_battle_flanking	tooltip_title_and_text
tooltip_battle_flying_units	tooltip_title_and_text
tooltip_battle_formations	tooltip_title_and_text
tooltip_battle_formations_button	tooltip_text_only
tooltip_battle_formations_link	tooltip_text_only
tooltip_battle_fortifications	tooltip_title_and_text
tooltip_battle_game_guide	tooltip_title_and_text
tooltip_battle_game_guide_link	tooltip_text_only
tooltip_battle_gates	tooltip_title_and_text
tooltip_battle_group_button	tooltip_text_only
tooltip_battle_grouping	tooltip_title_and_text
tooltip_battle_grouping_link	tooltip_text_only
tooltip_battle_guard_button	tooltip_text_only
tooltip_battle_harmony	tooltip_title_and_text
tooltip_battle_index	tooltip_text_only
tooltip_battle_infantry	tooltip_title_and_text
tooltip_battle_leadership	tooltip_title_and_text
tooltip_battle_lore_panel	tooltip_text_only
tooltip_battle_magic_barriers	tooltip_title_and_text
tooltip_battle_major_siege_battles	tooltip_title_and_text
tooltip_battle_mastery_of_the_elemental_winds	tooltip_title_and_text
tooltip_battle_melee_combat	tooltip_title_and_text
tooltip_battle_melee_mode_button	tooltip_text_only
tooltip_battle_minor_settlement_battles	tooltip_title_and_text
tooltip_battle_missile_units	tooltip_title_and_text
tooltip_battle_monsters	tooltip_title_and_text
tooltip_battle_mounted_units	tooltip_title_and_text
tooltip_battle_murderous_prowess	tooltip_title_and_text
tooltip_battle_plague_lords_blessings	tooltip_title_and_text
tooltip_battle_plague_lords_blessings_link	tooltip_text_only
tooltip_battle_plague_lords_blessings_meter	tooltip_text_only
tooltip_battle_power_reserve_bar	tooltip_text_only
tooltip_battle_radar_map	tooltip_text_only
tooltip_battle_rallying	tooltip_title_and_text
tooltip_battle_rampaging	tooltip_title_and_text
tooltip_battle_realm_of_souls	tooltip_title_and_text
tooltip_battle_realm_of_souls_link	tooltip_text_only
tooltip_battle_reign_of_chaos	tooltip_title_and_text
tooltip_battle_reign_of_chaos_link	tooltip_text_only
tooltip_battle_reign_of_chaos_meter	tooltip_text_only
tooltip_battle_reinforcements	tooltip_title_and_text
tooltip_battle_sensuous_seductions	tooltip_title_and_text
tooltip_battle_sensuous_seductions_link	tooltip_text_only
tooltip_battle_sensuous_seductions_meter	tooltip_text_only
tooltip_battle_siege_battles	tooltip_title_and_text
tooltip_battle_siege_weapons	tooltip_title_and_text
tooltip_battle_skirmish_button	tooltip_text_only
tooltip_battle_skirmishing	tooltip_title_and_text
tooltip_battle_skirmishing_link	tooltip_text_only
tooltip_battle_spells	tooltip_title_and_text
tooltip_battle_spells_link	tooltip_text_only
tooltip_battle_storm_of_magic_battles	tooltip_title_and_text
tooltip_battle_supplies	tooltip_title_and_text
tooltip_battle_supplies_link	tooltip_text_only
tooltip_battle_survival_battles	tooltip_title_and_text
tooltip_battle_tactical_map	tooltip_title_and_text
tooltip_battle_tactical_map_link	tooltip_text_only
tooltip_battle_terrain	tooltip_title_and_text
tooltip_battle_the_general	tooltip_title_and_text
tooltip_battle_time_controls	tooltip_text_only
tooltip_battle_time_limit	tooltip_text_only
tooltip_battle_towers	tooltip_title_and_text
tooltip_battle_unit_abilities	tooltip_title_and_text
tooltip_battle_unit_abilities_link	tooltip_text_only
tooltip_battle_unit_cards	tooltip_title_and_text
tooltip_battle_unit_cards_link	tooltip_text_only
tooltip_battle_unit_details_button	tooltip_text_only
tooltip_battle_unit_details_panel	tooltip_title_and_text
tooltip_battle_unit_details_panel_link	tooltip_text_only
tooltip_battle_unit_movement	tooltip_title_and_text
tooltip_battle_unit_portrait_panel	tooltip_text_only
tooltip_battle_unit_selection	tooltip_title_and_text
tooltip_battle_unit_types	tooltip_title_and_text
tooltip_battle_units	tooltip_title_and_text
tooltip_battle_units_link	tooltip_text_only
tooltip_battle_victory_locations	tooltip_title_and_text
tooltip_battle_victory_points	tooltip_title_and_text
tooltip_battle_victory_tickets	tooltip_text_only
tooltip_battle_vigour	tooltip_title_and_text
tooltip_battle_visibility	tooltip_title_and_text
tooltip_battle_walls	tooltip_title_and_text
tooltip_battle_weapon_types	tooltip_title_and_text
tooltip_battle_winds_of_magic	tooltip_title_and_text
tooltip_battle_winds_of_magic_link	tooltip_text_only
tooltip_battle_winds_of_magic_panel	tooltip_text_only
tooltip_battle_wizards	tooltip_title_and_text
tooltip_campaign_advice_history_buttons	tooltip_text_only
tooltip_campaign_advisor	tooltip_title_text_and_image
tooltip_campaign_advisor_button	tooltip_text_only
tooltip_campaign_advisor_link	tooltip_text_only
tooltip_campaign_age_of_reckoning	tooltip_title_and_text
tooltip_campaign_allegiance	tooltip_title_and_text
tooltip_campaign_alliances	tooltip_title_and_text
tooltip_campaign_allied_recruitment_panel	tooltip_text_only
tooltip_campaign_amanar	tooltip_title_and_text
tooltip_campaign_amber	tooltip_title_and_text
tooltip_campaign_ambushes	tooltip_title_and_text
tooltip_campaign_ariel	tooltip_title_and_text
tooltip_campaign_armies	tooltip_title_text_and_image
tooltip_campaign_armies_at_sea	tooltip_title_and_text
tooltip_campaign_armies_at_sea_link	tooltip_text_only
tooltip_campaign_armies_link	tooltip_text_only
tooltip_campaign_army_movement	tooltip_title_and_text
tooltip_campaign_army_panel	tooltip_title_and_text
tooltip_campaign_army_panel_link	tooltip_text_only
tooltip_campaign_artefact_vault	tooltip_title_and_text
tooltip_campaign_asrai_lookouts	tooltip_title_and_text
tooltip_campaign_astromancy	tooltip_title_and_text
tooltip_campaign_atamans	tooltip_title_and_text
tooltip_campaign_atamans_button	tooltip_text_only
tooltip_campaign_atamans_link	tooltip_text_only
tooltip_campaign_atamans_panel	tooltip_text_only
tooltip_campaign_athel_tamarha	tooltip_title_and_text
tooltip_campaign_attrition	tooltip_title_and_text
tooltip_campaign_autoresolve_button	tooltip_text_only
tooltip_campaign_autoresolving	tooltip_title_and_text
tooltip_campaign_balance_of_power_bar	tooltip_text_only
tooltip_campaign_bankruptcy	tooltip_title_and_text
tooltip_campaign_banners_and_marks	tooltip_title_and_text
tooltip_campaign_banners_and_marks_link	tooltip_text_only
tooltip_campaign_battles	tooltip_title_text_and_image
tooltip_campaign_beast_paths	tooltip_title_and_text
tooltip_campaign_beastmen	tooltip_title_text_and_image
tooltip_campaign_bestial_rage	tooltip_title_and_text
tooltip_campaign_bestial_rage_link	tooltip_text_only
tooltip_campaign_big_names	tooltip_title_and_text
tooltip_campaign_big_names_link	tooltip_text_only
tooltip_campaign_black_arks	tooltip_title_and_text
tooltip_campaign_blessed_spawnings	tooltip_title_and_text
tooltip_campaign_blessed_spawnings_button	tooltip_text_only
tooltip_campaign_blessing_lady	tooltip_title_and_text
tooltip_campaign_blockades	tooltip_title_and_text
tooltip_campaign_blood_hosts	tooltip_title_and_text
tooltip_campaign_blood_kiss	tooltip_text_only
tooltip_campaign_blood_voyage	tooltip_title_and_text
tooltip_campaign_blood_voyage_link	tooltip_text_only
tooltip_campaign_bloodgrounds	tooltip_title_and_text
tooltip_campaign_bloodletting	tooltip_title_and_text
tooltip_campaign_bloodletting_link	tooltip_text_only
tooltip_campaign_bloodlines	tooltip_title_and_text
tooltip_campaign_bloodlines_panel	tooltip_text_only
tooltip_campaign_books_of_nagash	tooltip_title_and_text
tooltip_campaign_books_of_nagash_link	tooltip_text_only
tooltip_campaign_books_of_nagash_panel	tooltip_text_only
tooltip_campaign_brayherds	tooltip_title_and_text
tooltip_campaign_bretonnia	tooltip_title_text_and_image
tooltip_campaign_bretonnian_desert_thirst	tooltip_title_and_text
tooltip_campaign_bretonnian_vows	tooltip_title_and_text
tooltip_campaign_building_browser	tooltip_text_only
tooltip_campaign_building_panel	tooltip_title_and_text
tooltip_campaign_building_panel_link	tooltip_text_only
tooltip_campaign_building_panel_tab	tooltip_text_only
tooltip_campaign_building_slots	tooltip_title_and_text
tooltip_campaign_building_slots_link	tooltip_text_only
tooltip_campaign_building_tab	tooltip_text_only
tooltip_campaign_building_types	tooltip_title_and_text
tooltip_campaign_buildings	tooltip_title_and_text
tooltip_campaign_buildings_link	tooltip_text_only
tooltip_campaign_campaign_controls	tooltip_title_and_text
tooltip_campaign_campaign_game	tooltip_title_text_and_image
tooltip_campaign_campaign_map	tooltip_title_text_and_image
tooltip_campaign_canopic_jars	tooltip_title_and_text
tooltip_campaign_canopic_jars_link	tooltip_text_only
tooltip_campaign_cathay	tooltip_title_text_and_image
tooltip_campaign_changing_of_the_ways	tooltip_title_and_text
tooltip_campaign_changing_of_the_ways_link	tooltip_text_only
tooltip_campaign_changing_of_the_ways_panel	tooltip_text_only
tooltip_campaign_chaos	tooltip_title_text_and_image
tooltip_campaign_chaos_artefacts	tooltip_title_and_text
tooltip_campaign_chaos_corruption	tooltip_title_and_text
tooltip_campaign_chaos_cults	tooltip_title_and_text
tooltip_campaign_chaos_dwarfs	tooltip_title_text_and_image
tooltip_campaign_chaos_gifts	tooltip_title_and_text
tooltip_campaign_chaos_rifts	tooltip_title_and_text
tooltip_campaign_chapter_objectives	tooltip_text_only
tooltip_campaign_character_available_skill_points	tooltip_text_only
tooltip_campaign_character_details	tooltip_title_and_text
tooltip_campaign_character_details_button	tooltip_text_only
tooltip_campaign_character_details_link	tooltip_text_only
tooltip_campaign_character_details_panel	tooltip_title_and_text
tooltip_campaign_character_details_panel_abilities	tooltip_text_only
tooltip_campaign_character_details_panel_character_stats	tooltip_text_only
tooltip_campaign_character_details_panel_details_button	tooltip_text_only
tooltip_campaign_character_details_panel_details_traits_and_effects	tooltip_text_only
tooltip_campaign_character_details_panel_link	tooltip_text_only
tooltip_campaign_character_details_panel_quests_button	tooltip_text_only
tooltip_campaign_character_details_panel_skills_button	tooltip_text_only
tooltip_campaign_character_info_panel	tooltip_title_and_text
tooltip_campaign_character_info_panel_link	tooltip_text_only
tooltip_campaign_character_magic_items	tooltip_text_only
tooltip_campaign_character_skills	tooltip_title_and_text
tooltip_campaign_character_skills_link	tooltip_text_only
tooltip_campaign_character_traits	tooltip_text_only
tooltip_campaign_characters	tooltip_title_text_and_image
tooltip_campaign_chd_economy	tooltip_title_and_text
tooltip_campaign_chd_economy_link	tooltip_text_only
tooltip_campaign_chieftains	tooltip_title_and_text
tooltip_campaign_chieftains_link	tooltip_text_only
tooltip_campaign_chivalry	tooltip_title_and_text
tooltip_campaign_chivalry_link	tooltip_text_only
tooltip_campaign_cloak_of_skulls	tooltip_title_and_text
tooltip_campaign_cloak_of_skulls_link	tooltip_text_only
tooltip_campaign_colleges_of_magic	tooltip_title_and_text
tooltip_campaign_colleges_of_magic_link	tooltip_text_only
tooltip_campaign_commandments	tooltip_title_and_text
tooltip_campaign_commandments_link	tooltip_text_only
tooltip_campaign_commandments_rollout	tooltip_text_only
tooltip_campaign_compass	tooltip_title_and_text
tooltip_campaign_compass_link	tooltip_text_only
tooltip_campaign_compass_panel	tooltip_text_only
tooltip_campaign_conclave_influence_link	tooltip_text_only
tooltip_campaign_confederation	tooltip_title_and_text
tooltip_campaign_confederation_link	tooltip_text_only
tooltip_campaign_contents	tooltip_text_only
tooltip_campaign_contracts	tooltip_title_and_text
tooltip_campaign_contracts_link	tooltip_text_only
tooltip_campaign_contracts_panel	tooltip_text_only
tooltip_campaign_corruption	tooltip_title_and_text
tooltip_campaign_corruption_link	tooltip_text_only
tooltip_campaign_cyclical_buildings	tooltip_title_and_text
tooltip_campaign_da_plan	tooltip_title_and_text
tooltip_campaign_daemonic_gifts	tooltip_text_only
tooltip_campaign_daemonic_glory	tooltip_title_and_text
tooltip_campaign_daemonic_glory_link	tooltip_text_only
tooltip_campaign_daemonic_glory_panel	tooltip_text_only
tooltip_campaign_daemons_of_chaos	tooltip_title_text_and_image
tooltip_campaign_dark_authority	tooltip_title_and_text
tooltip_campaign_dark_elf_loyalty	tooltip_title_and_text
tooltip_campaign_dark_elves	tooltip_title_text_and_image
tooltip_campaign_dark_elves_possession_tzarkan	tooltip_title_and_text
tooltip_campaign_dark_fortress	tooltip_title_and_text
tooltip_campaign_day_of_awakening	tooltip_title_and_text
tooltip_campaign_death_night	tooltip_title_and_text
tooltip_campaign_death_night_bar	tooltip_text_only
tooltip_campaign_death_night_button	tooltip_text_only
tooltip_campaign_death_night_link	tooltip_text_only
tooltip_campaign_dedication	tooltip_title_and_text
tooltip_campaign_dedication_link	tooltip_text_only
tooltip_campaign_defence_great_plan	tooltip_title_and_text
tooltip_campaign_defender_of_ulthuan	tooltip_title_and_text
tooltip_campaign_defender_of_ulthuan_link	tooltip_text_only
tooltip_campaign_devotees	tooltip_title_text_and_image
tooltip_campaign_devotees_counter	tooltip_text_only
tooltip_campaign_devotees_link	tooltip_text_only
tooltip_campaign_devotion	tooltip_title_and_text
tooltip_campaign_devotion_icon	tooltip_text_only
tooltip_campaign_devotion_link	tooltip_text_only
tooltip_campaign_devotion_value	tooltip_text_only
tooltip_campaign_diplomacy	tooltip_title_text_and_image
tooltip_campaign_diplomacy_attitude_icons	tooltip_text_only
tooltip_campaign_diplomacy_button	tooltip_text_only
tooltip_campaign_diplomacy_centre_panel	tooltip_text_only
tooltip_campaign_diplomacy_screen	tooltip_title_and_text
tooltip_campaign_diplomacy_screen_link	tooltip_text_only
tooltip_campaign_disciple_armies	tooltip_title_and_text
tooltip_campaign_disciple_armies_link	tooltip_text_only
tooltip_campaign_dragon_taming	tooltip_title_and_text
tooltip_campaign_drawn_to_destruction	tooltip_title_and_text
tooltip_campaign_dread	tooltip_title_and_text
tooltip_campaign_drill_of_hashut	tooltip_title_and_text
tooltip_campaign_drill_of_hashut_link	tooltip_text_only
tooltip_campaign_drop_down_lists	tooltip_title_and_text
tooltip_campaign_drop_down_lists_link	tooltip_text_only
tooltip_campaign_dwarfs	tooltip_title_text_and_image
tooltip_campaign_dynasties	tooltip_title_and_text
tooltip_campaign_dynasties_link	tooltip_text_only
tooltip_campaign_dynasties_panel	tooltip_text_only
tooltip_campaign_electoral_machinations	tooltip_title_and_text
tooltip_campaign_electoral_machinations_link	tooltip_text_only
tooltip_campaign_elf_glamouring	tooltip_title_and_text
tooltip_campaign_elven_council	tooltip_title_and_text
tooltip_campaign_elven_halls	tooltip_title_and_text
tooltip_campaign_emperors_mandate	tooltip_title_and_text
tooltip_campaign_empire	tooltip_title_text_and_image
tooltip_campaign_empowering_the_compass	tooltip_title_and_text
tooltip_campaign_encounters_at_sea	tooltip_title_and_text
tooltip_campaign_end_turn_button	tooltip_text_only
tooltip_campaign_espionage	tooltip_title_and_text
tooltip_campaign_events_list	tooltip_text_only
tooltip_campaign_exalted_greater_daemons	tooltip_title_and_text
tooltip_campaign_faction_interfaces	tooltip_title_and_text
tooltip_campaign_faction_management	tooltip_title_and_text
tooltip_campaign_faction_summary_button	tooltip_text_only
tooltip_campaign_faction_summary_records_tab	tooltip_text_only
tooltip_campaign_faction_summary_screen	tooltip_title_and_text
tooltip_campaign_faction_summary_screen_link	tooltip_text_only
tooltip_campaign_faction_summary_statistics_tab	tooltip_text_only
tooltip_campaign_faction_summary_summary_tab	tooltip_text_only
tooltip_campaign_factions	tooltip_title_text_and_image
tooltip_campaign_factions_list	tooltip_text_only
tooltip_campaign_fightiness	tooltip_title_and_text
tooltip_campaign_fightiness_bar	tooltip_text_only
tooltip_campaign_fightiness_link	tooltip_text_only
tooltip_campaign_fleet_office	tooltip_title_and_text
tooltip_campaign_fleet_office_link	tooltip_text_only
tooltip_campaign_fleet_office_panel	tooltip_text_only
tooltip_campaign_flesh_lab	tooltip_title_and_text
tooltip_campaign_fog_of_war	tooltip_title_and_text
tooltip_campaign_followers	tooltip_text_only
tooltip_campaign_food	tooltip_title_and_text
tooltip_campaign_food_bar	tooltip_text_only
tooltip_campaign_food_link	tooltip_text_only
tooltip_campaign_forbidden_workshop	tooltip_title_and_text
tooltip_campaign_forces_list	tooltip_text_only
tooltip_campaign_forest_spirits_animals	tooltip_title_and_text
tooltip_campaign_forge_of_daith	tooltip_title_and_text
tooltip_campaign_forge_of_souls	tooltip_title_and_text
tooltip_campaign_forging_magic_items	tooltip_title_and_text
tooltip_campaign_forging_magic_items_button	tooltip_text_only
tooltip_campaign_forging_magic_items_link	tooltip_text_only
tooltip_campaign_forging_magic_items_panel	tooltip_text_only
tooltip_campaign_fortifications	tooltip_title_and_text
tooltip_campaign_fortifications_link	tooltip_text_only
tooltip_campaign_game_guide	tooltip_title_and_text
tooltip_campaign_gardens_of_morr	tooltip_title_and_text
tooltip_campaign_gardens_of_morr_link	tooltip_text_only
tooltip_campaign_garrison_armies	tooltip_title_and_text
tooltip_campaign_garrison_armies_link	tooltip_text_only
tooltip_campaign_garrison_details_button	tooltip_text_only
tooltip_campaign_gathering_of_the_ancients	tooltip_title_and_text
tooltip_campaign_gathering_of_the_ancients_link	tooltip_text_only
tooltip_campaign_gathering_of_the_ancients_panel	tooltip_text_only
tooltip_campaign_geomantic_web	tooltip_title_and_text
tooltip_campaign_geomantic_web_button	tooltip_text_only
tooltip_campaign_geomantic_web_link	tooltip_text_only
tooltip_campaign_gifts_of_slaanesh	tooltip_title_and_text
tooltip_campaign_global_item_pool	tooltip_text_only
tooltip_campaign_global_recruitment_pool	tooltip_text_only
tooltip_campaign_gods	tooltip_title_and_text
tooltip_campaign_gods_link	tooltip_text_only
tooltip_campaign_gotrek_and_felix	tooltip_title_and_text
tooltip_campaign_great_bastion	tooltip_title_and_text
tooltip_campaign_great_bastion_link	tooltip_text_only
tooltip_campaign_great_bastion_threat_meter	tooltip_text_only
tooltip_campaign_great_vortex	tooltip_title_and_text
tooltip_campaign_green_knight	tooltip_title_and_text
tooltip_campaign_green_knight_link	tooltip_text_only
tooltip_campaign_greenskins	tooltip_title_text_and_image
tooltip_campaign_grimoires	tooltip_title_and_text
tooltip_campaign_grimoires_counter	tooltip_text_only
tooltip_campaign_grimoires_link	tooltip_text_only
tooltip_campaign_groms_cauldron	tooltip_title_and_text
tooltip_campaign_growth	tooltip_title_and_text
tooltip_campaign_growth_link	tooltip_text_only
tooltip_campaign_grudges	tooltip_title_and_text
tooltip_campaign_grudges_bar	tooltip_text_only
tooltip_campaign_grudges_button	tooltip_text_only
tooltip_campaign_grudges_link	tooltip_text_only
tooltip_campaign_harmony	tooltip_title_and_text
tooltip_campaign_harmony_link	tooltip_text_only
tooltip_campaign_harmony_lotus_indicator	tooltip_text_only
tooltip_campaign_hellforge	tooltip_title_and_text
tooltip_campaign_hellforge_link	tooltip_text_only
tooltip_campaign_hellforge_panel	tooltip_text_only
tooltip_campaign_help_pages_button	tooltip_text_only
tooltip_campaign_hero_actions	tooltip_title_and_text
tooltip_campaign_hero_deployment_button	tooltip_text_only
tooltip_campaign_hero_recruitment_button	tooltip_text_only
tooltip_campaign_hero_recruitment_panel_tab_buttons	tooltip_text_only
tooltip_campaign_heroes	tooltip_title_and_text
tooltip_campaign_heroes_link	tooltip_text_only
tooltip_campaign_hexes	tooltip_title_and_text
tooltip_campaign_high_elves	tooltip_title_text_and_image
tooltip_campaign_horde_growth	tooltip_title_and_text
tooltip_campaign_horde_growth_link	tooltip_text_only
tooltip_campaign_hordes	tooltip_title_and_text
tooltip_campaign_hostility	tooltip_title_and_text
tooltip_campaign_ice_court	tooltip_title_and_text
tooltip_campaign_ice_court_button	tooltip_text_only
tooltip_campaign_ice_court_link	tooltip_text_only
tooltip_campaign_ice_court_panel	tooltip_text_only
tooltip_campaign_imperial_authority	tooltip_title_and_text
tooltip_campaign_imperial_gunnery_school	tooltip_title_and_text
tooltip_campaign_imperial_gunnery_school_link	tooltip_text_only
tooltip_campaign_income	tooltip_title_and_text
tooltip_campaign_income_link	tooltip_text_only
tooltip_campaign_income_per_turn	tooltip_text_only
tooltip_campaign_index	tooltip_text_only
tooltip_campaign_infamy	tooltip_title_and_text
tooltip_campaign_infamy_link	tooltip_text_only
tooltip_campaign_infections	tooltip_text_only
tooltip_campaign_influence	tooltip_title_and_text
tooltip_campaign_influence_link	tooltip_text_only
tooltip_campaign_intervention_armies	tooltip_title_and_text
tooltip_campaign_interventions_button	tooltip_text_only
tooltip_campaign_intrigue_at_the_court	tooltip_title_and_text
tooltip_campaign_intrigue_at_the_court_button	tooltip_text_only
tooltip_campaign_intrigue_at_the_court_panel	tooltip_text_only
tooltip_campaign_ivory_road	tooltip_title_and_text
tooltip_campaign_ivory_road_link	tooltip_text_only
tooltip_campaign_ivory_road_panel	tooltip_text_only
tooltip_campaign_jungle_nexus	tooltip_title_and_text
tooltip_campaign_khorne	tooltip_title_text_and_image
tooltip_campaign_kislev	tooltip_title_text_and_image
tooltip_campaign_labour	tooltip_title_and_text
tooltip_campaign_labour_link	tooltip_text_only
tooltip_campaign_legendary_knight_button	tooltip_text_only
tooltip_campaign_lizardmen	tooltip_title_text_and_image
tooltip_campaign_local_recruitment_pool	tooltip_text_only
tooltip_campaign_lord_kroak	tooltip_title_and_text
tooltip_campaign_lords	tooltip_title_and_text
tooltip_campaign_loyalty	tooltip_title_and_text
tooltip_campaign_magic_items	tooltip_title_and_text
tooltip_campaign_malakais_adventures	tooltip_title_and_text
tooltip_campaign_malakais_adventures_link	tooltip_text_only
tooltip_campaign_marked_for_death	tooltip_title_and_text
tooltip_campaign_marked_for_death_button	tooltip_text_only
tooltip_campaign_marked_for_death_link	tooltip_text_only
tooltip_campaign_marks_of_ruination	tooltip_title_and_text
tooltip_campaign_matters_of_state	tooltip_title_and_text
tooltip_campaign_meat	tooltip_title_and_text
tooltip_campaign_meat_link	tooltip_text_only
tooltip_campaign_mercenary_contracts	tooltip_title_and_text
tooltip_campaign_mercenary_contracts_link	tooltip_text_only
tooltip_campaign_military_convoys	tooltip_title_and_text
tooltip_campaign_military_convoys_link	tooltip_text_only
tooltip_campaign_missions	tooltip_title_and_text
tooltip_campaign_missions_list	tooltip_title_and_text
tooltip_campaign_missions_list_link	tooltip_text_only
tooltip_campaign_money	tooltip_title_and_text
tooltip_campaign_monster_pens	tooltip_title_and_text
tooltip_campaign_monsters	tooltip_title_and_text
tooltip_campaign_monsters_link	tooltip_text_only
tooltip_campaign_mortal_worlds_torment	tooltip_title_and_text
tooltip_campaign_mortal_worlds_torment_link	tooltip_text_only
tooltip_campaign_mortuary_cult	tooltip_title_and_text
tooltip_campaign_mortuary_cult_button	tooltip_text_only
tooltip_campaign_mortuary_cult_link	tooltip_text_only
tooltip_campaign_mortuary_cult_panel	tooltip_text_only
tooltip_campaign_motherland	tooltip_title_text_and_image
tooltip_campaign_motherland_link	tooltip_text_only
tooltip_campaign_motherland_panel	tooltip_text_only
tooltip_campaign_movement_range	tooltip_text_only
tooltip_campaign_navies	tooltip_title_and_text
tooltip_campaign_nemesis_crown	tooltip_title_text_and_image
tooltip_campaign_new_worldroots	tooltip_title_and_text
tooltip_campaign_non_aggression_pacts	tooltip_title_and_text
tooltip_campaign_non_aggression_pacts_link	tooltip_text_only
tooltip_campaign_norsca	tooltip_title_text_and_image
tooltip_campaign_norscan_homelands	tooltip_title_and_text
tooltip_campaign_nurgle	tooltip_title_text_and_image
tooltip_campaign_oak_of_ages	tooltip_title_and_text
tooltip_campaign_oathgold	tooltip_title_and_text
tooltip_campaign_oathgold_button	tooltip_text_only
tooltip_campaign_oathgold_link	tooltip_text_only
tooltip_campaign_oathgold_panel	tooltip_text_only
tooltip_campaign_objectives_button	tooltip_text_only
tooltip_campaign_objectives_chapter_missions_tab	tooltip_text_only
tooltip_campaign_objectives_panel	tooltip_title_and_text
tooltip_campaign_objectives_panel_link	tooltip_text_only
tooltip_campaign_objectives_victory_conditions_tab	tooltip_text_only
tooltip_campaign_offer_to_the_great_maw_panel	tooltip_text_only
tooltip_campaign_offices	tooltip_title_and_text
tooltip_campaign_offices_button	tooltip_text_only
tooltip_campaign_offices_link	tooltip_text_only
tooltip_campaign_ogre_camps	tooltip_title_text_and_image
tooltip_campaign_ogre_camps_link	tooltip_text_only
tooltip_campaign_ogre_kingdoms	tooltip_title_text_and_image
tooltip_campaign_outposts	tooltip_title_and_text
tooltip_campaign_oxyotl_visions	tooltip_title_and_text
tooltip_campaign_path_of_the_butcher	tooltip_title_and_text
tooltip_campaign_path_to_glory	tooltip_title_and_text
tooltip_campaign_peasants	tooltip_title_and_text
tooltip_campaign_peasants_link	tooltip_text_only
tooltip_campaign_pieces_of_eight	tooltip_title_and_text
tooltip_campaign_pieces_of_eight_link	tooltip_text_only
tooltip_campaign_pirate_coves	tooltip_title_and_text
tooltip_campaign_pirate_coves_link	tooltip_text_only
tooltip_campaign_plague_cauldron_panel	tooltip_text_only
tooltip_campaign_plague_recipes	tooltip_text_only
tooltip_campaign_plagues	tooltip_title_and_text
tooltip_campaign_plagues_of_nurgle	tooltip_title_and_text
tooltip_campaign_plagues_of_nurgle_link	tooltip_text_only
tooltip_campaign_pleasurable_acts	tooltip_title_and_text
tooltip_campaign_pleasurable_acts_buttons	tooltip_text_only
tooltip_campaign_pleasurable_acts_link	tooltip_text_only
tooltip_campaign_ports	tooltip_title_and_text
tooltip_campaign_ports_link	tooltip_text_only
tooltip_campaign_post_battle_options	tooltip_title_and_text
tooltip_campaign_post_battle_options_link	tooltip_text_only
tooltip_campaign_post_battle_panel	tooltip_title_and_text
tooltip_campaign_post_battle_panel_link	tooltip_text_only
tooltip_campaign_power_of_nature	tooltip_title_and_text
tooltip_campaign_power_of_nature_link	tooltip_text_only
tooltip_campaign_pre_battle_options	tooltip_title_and_text
tooltip_campaign_pre_battle_options_link	tooltip_text_only
tooltip_campaign_pre_battle_panel	tooltip_title_and_text
tooltip_campaign_pre_battle_panel_link	tooltip_text_only
tooltip_campaign_proliferate_cults_button	tooltip_text_only
tooltip_campaign_province_info_panel	tooltip_title_and_text
tooltip_campaign_province_info_panel_link	tooltip_text_only
tooltip_campaign_province_management	tooltip_title_and_text
tooltip_campaign_province_overview_panel	tooltip_title_and_text
tooltip_campaign_province_overview_panel_link	tooltip_text_only
tooltip_campaign_provinces	tooltip_title_text_and_image
tooltip_campaign_provinces_list	tooltip_text_only
tooltip_campaign_public_order	tooltip_title_and_text
tooltip_campaign_public_order_bar	tooltip_text_only
tooltip_campaign_public_order_icon	tooltip_text_only
tooltip_campaign_public_order_link	tooltip_text_only
tooltip_campaign_quests	tooltip_title_and_text
tooltip_campaign_races	tooltip_title_text_and_image
tooltip_campaign_raiding	tooltip_title_and_text
tooltip_campaign_raise_dead_button	tooltip_text_only
tooltip_campaign_raise_forces_button	tooltip_text_only
tooltip_campaign_raise_forces_panel	tooltip_text_only
tooltip_campaign_raising_dead	tooltip_title_and_text
tooltip_campaign_raising_dead_link	tooltip_text_only
tooltip_campaign_raising_forces	tooltip_title_and_text
tooltip_campaign_raising_forces_link	tooltip_text_only
tooltip_campaign_rampage	tooltip_title_and_text
tooltip_campaign_razing	tooltip_title_and_text
tooltip_campaign_realm_of_chaos	tooltip_title_and_text
tooltip_campaign_recruit_black_ark_button	tooltip_text_only
tooltip_campaign_recruit_hero_panel	tooltip_title_and_text
tooltip_campaign_recruit_hero_panel_link	tooltip_text_only
tooltip_campaign_recruitment_capacity	tooltip_text_only
tooltip_campaign_regiments_of_renown	tooltip_title_and_text
tooltip_campaign_regiments_of_renown_link	tooltip_text_only
tooltip_campaign_regiments_of_renown_panel	tooltip_text_only
tooltip_campaign_region_trading	tooltip_title_and_text
tooltip_campaign_reinforcements	tooltip_title_and_text
tooltip_campaign_reinforcements_link	tooltip_text_only
tooltip_campaign_resources	tooltip_title_and_text
tooltip_campaign_revolts	tooltip_title_and_text
tooltip_campaign_rites	tooltip_title_and_text
tooltip_campaign_rites_button	tooltip_text_only
tooltip_campaign_rites_panel	tooltip_text_only
tooltip_campaign_ritual_buttons	tooltip_text_only
tooltip_campaign_ritual_currency	tooltip_title_and_text
tooltip_campaign_ritual_resource_sites	tooltip_title_and_text
tooltip_campaign_ritual_rival_icons	tooltip_text_only
tooltip_campaign_rituals	tooltip_title_and_text
tooltip_campaign_rituals_bar	tooltip_title_and_text
tooltip_campaign_rituals_bar_link	tooltip_text_only
tooltip_campaign_rogue_armies	tooltip_title_and_text
tooltip_campaign_rogue_pirates	tooltip_title_and_text
tooltip_campaign_ruins	tooltip_title_and_text
tooltip_campaign_sacrifice_to_sotek	tooltip_title_and_text
tooltip_campaign_salvage	tooltip_title_and_text
tooltip_campaign_saving_and_loading	tooltip_title_and_text
tooltip_campaign_schemes	tooltip_title_and_text
tooltip_campaign_sea	tooltip_title_and_text
tooltip_campaign_sea_lanes	tooltip_title_and_text
tooltip_campaign_sea_shanties	tooltip_title_and_text
tooltip_campaign_seduce_units_button	tooltip_text_only
tooltip_campaign_seduction	tooltip_title_text_and_image
tooltip_campaign_seduction_link	tooltip_text_only
tooltip_campaign_seductive_influence	tooltip_title_and_text
tooltip_campaign_seductive_influence_link	tooltip_text_only
tooltip_campaign_settlement_abandonment	tooltip_title_and_text
tooltip_campaign_settlement_bars	tooltip_text_only
tooltip_campaign_settlement_climates	tooltip_title_and_text
tooltip_campaign_settlement_trading_link	tooltip_text_only
tooltip_campaign_settlement_types	tooltip_title_and_text
tooltip_campaign_settlement_types_link	tooltip_text_only
tooltip_campaign_settlements	tooltip_title_text_and_image
tooltip_campaign_settlements_link	tooltip_text_only
tooltip_campaign_ship_building	tooltip_title_and_text
tooltip_campaign_ship_building_link	tooltip_text_only
tooltip_campaign_siege_panel	tooltip_title_and_text
tooltip_campaign_siege_panel_link	tooltip_text_only
tooltip_campaign_siege_warfare	tooltip_title_and_text
tooltip_campaign_siege_weapons	tooltip_title_and_text
tooltip_campaign_silent_sanctums	tooltip_title_and_text
tooltip_campaign_skaven	tooltip_title_text_and_image
tooltip_campaign_skaven_corruption	tooltip_title_and_text
tooltip_campaign_skaven_loyalty	tooltip_title_and_text
tooltip_campaign_skaven_shadowy_dealings	tooltip_title_and_text
tooltip_campaign_skaven_underworld	tooltip_title_and_text
tooltip_campaign_skull_throne	tooltip_title_and_text
tooltip_campaign_skull_throne_link	tooltip_text_only
tooltip_campaign_skulls	tooltip_title_and_text
tooltip_campaign_skulls_counter	tooltip_text_only
tooltip_campaign_skulls_link	tooltip_text_only
tooltip_campaign_slaanesh	tooltip_title_text_and_image
tooltip_campaign_slaves	tooltip_title_and_text
tooltip_campaign_slaves_button	tooltip_text_only
tooltip_campaign_slaves_buttons	tooltip_text_only
tooltip_campaign_slaves_link	tooltip_text_only
tooltip_campaign_souls_resource	tooltip_title_and_text
tooltip_campaign_spirit_of_grungni	tooltip_title_and_text
tooltip_campaign_spirit_of_grungni_link	tooltip_text_only
tooltip_campaign_stances	tooltip_title_and_text
tooltip_campaign_stances_link	tooltip_text_only
tooltip_campaign_stances_rollout	tooltip_text_only
tooltip_campaign_strategic_map	tooltip_title_and_text
tooltip_campaign_strategic_map_button	tooltip_text_only
tooltip_campaign_strategic_map_layer_buttons	tooltip_text_only
tooltip_campaign_strategic_map_link	tooltip_text_only
tooltip_campaign_summon_disciple_army_button	tooltip_text_only
tooltip_campaign_summon_elector_counts	tooltip_title_and_text
tooltip_campaign_supporters_track	tooltip_text_only
tooltip_campaign_sword_of_khaine	tooltip_title_and_text
tooltip_campaign_sword_of_khaine_link	tooltip_text_only
tooltip_campaign_symptoms	tooltip_text_only
tooltip_campaign_tally	tooltip_title_and_text
tooltip_campaign_tally_link	tooltip_text_only
tooltip_campaign_tax	tooltip_title_and_text
tooltip_campaign_tax_link	tooltip_text_only
tooltip_campaign_technology	tooltip_title_and_text
tooltip_campaign_technology_button	tooltip_text_only
tooltip_campaign_technology_link	tooltip_text_only
tooltip_campaign_technology_panel	tooltip_text_only
tooltip_campaign_technology_panel_link	tooltip_text_only
tooltip_campaign_teleport_stance	tooltip_title_and_text
tooltip_campaign_teleport_stance_link	tooltip_text_only
tooltip_campaign_terrain_types	tooltip_title_and_text
tooltip_campaign_the_great_game	tooltip_title_and_text
tooltip_campaign_the_menace_below	tooltip_title_and_text
tooltip_campaign_tomb_kings	tooltip_title_text_and_image
tooltip_campaign_tower_of_zharr	tooltip_title_and_text
tooltip_campaign_tower_of_zharr_link	tooltip_text_only
tooltip_campaign_trade	tooltip_title_and_text
tooltip_campaign_trade_link	tooltip_text_only
tooltip_campaign_treasure_maps	tooltip_title_and_text
tooltip_campaign_treasure_maps_list	tooltip_text_only
tooltip_campaign_treasure_maps_panel	tooltip_text_only
tooltip_campaign_treasury	tooltip_text_only
tooltip_campaign_treasury_button	tooltip_text_only
tooltip_campaign_treasury_panel	tooltip_title_and_text
tooltip_campaign_treasury_panel_details_tab	tooltip_text_only
tooltip_campaign_treasury_panel_link	tooltip_text_only
tooltip_campaign_treasury_panel_summary_tab	tooltip_text_only
tooltip_campaign_treasury_panel_trade_tab	tooltip_text_only
tooltip_campaign_tribal_confederation	tooltip_title_and_text
tooltip_campaign_trickster_cults	tooltip_title_and_text
tooltip_campaign_turns	tooltip_title_and_text
tooltip_campaign_tyrants_demands	tooltip_title_and_text
tooltip_campaign_tzeentch	tooltip_title_text_and_image
tooltip_campaign_underway	tooltip_title_and_text
tooltip_campaign_unholy_manifestations	tooltip_title_and_text
tooltip_campaign_unholy_manifestations_link	tooltip_text_only
tooltip_campaign_unholy_manifestations_panel	tooltip_text_only
tooltip_campaign_unit_cards	tooltip_title_and_text
tooltip_campaign_unit_cards_link	tooltip_text_only
tooltip_campaign_unit_exchange	tooltip_title_and_text
tooltip_campaign_unit_exchange_panel	tooltip_text_only
tooltip_campaign_unit_experience	tooltip_title_and_text
tooltip_campaign_unit_experience_link	tooltip_text_only
tooltip_campaign_unit_info_panel	tooltip_title_and_text
tooltip_campaign_unit_info_panel_link	tooltip_text_only
tooltip_campaign_unit_merging_and_disbanding	tooltip_title_and_text
tooltip_campaign_unit_recruitment	tooltip_title_and_text
tooltip_campaign_unit_recruitment_button	tooltip_text_only
tooltip_campaign_unit_recruitment_link	tooltip_text_only
tooltip_campaign_unit_recruitment_panel	tooltip_title_and_text
tooltip_campaign_unit_recruitment_panel_link	tooltip_text_only
tooltip_campaign_unit_replenishment	tooltip_title_and_text
tooltip_campaign_unit_types	tooltip_title_and_text
tooltip_campaign_unit_types_link	tooltip_text_only
tooltip_campaign_units	tooltip_title_text_and_image
tooltip_campaign_ursun	tooltip_title_text_and_image
tooltip_campaign_vampire_coast	tooltip_title_text_and_image
tooltip_campaign_vampires	tooltip_title_text_and_image
tooltip_campaign_vampiric_corruption	tooltip_title_and_text
tooltip_campaign_vampiric_loyalty	tooltip_title_and_text
tooltip_campaign_vassalage	tooltip_title_and_text
tooltip_campaign_victory_conditions	tooltip_title_and_text
tooltip_campaign_victory_conditions_link	tooltip_text_only
tooltip_campaign_visions_button	tooltip_text_only
tooltip_campaign_waaagh	tooltip_title_and_text
tooltip_campaign_war	tooltip_title_and_text
tooltip_campaign_war_coordination	tooltip_title_and_text
tooltip_campaign_war_coordination_ally_missions_tab	tooltip_text_only
tooltip_campaign_war_coordination_button	tooltip_text_only
tooltip_campaign_war_coordination_link	tooltip_text_only
tooltip_campaign_war_coordination_outpost_tab	tooltip_text_only
tooltip_campaign_war_coordination_panel	tooltip_text_only
tooltip_campaign_war_coordination_request_army_tab	tooltip_text_only
tooltip_campaign_war_coordination_set_target_tab	tooltip_text_only
tooltip_campaign_warbands	tooltip_title_and_text
tooltip_campaign_warmblood_invaders	tooltip_title_and_text
tooltip_campaign_warriors_of_chaos	tooltip_title_text_and_image
tooltip_campaign_winds_of_magic	tooltip_title_and_text
tooltip_campaign_winds_of_magic_link	tooltip_text_only
tooltip_campaign_winds_of_magic_manipulation	tooltip_title_and_text
tooltip_campaign_winds_of_magic_manipulation_link	tooltip_text_only
tooltip_campaign_winds_of_magic_manipulation_panel	tooltip_text_only
tooltip_campaign_winds_of_magic_power_reserve_bar	tooltip_text_only
tooltip_campaign_witchs_hut	tooltip_title_and_text
tooltip_campaign_witchs_hut_panel	tooltip_text_only
tooltip_campaign_wood_elves	tooltip_title_text_and_image
tooltip_campaign_worldroots	tooltip_title_and_text
tooltip_campaign_wrath_of_khorne	tooltip_title_and_text
tooltip_campaign_wrath_of_khorne_link	tooltip_text_only
tooltip_campaign_wulfharts_hunters	tooltip_title_and_text
tooltip_campaign_zones_of_control	tooltip_title_and_text
tooltip_how_to_play_title	tooltip_text_only
tooltip_reinforcement_point	tooltip_title_and_text
tooltip_tribal_confederation	tooltip_title_and_text
