achievement_key	condition_key
#achievement_subculture_condition_junctions_tables;0;db/achievement_subculture_condition_junctions_tables/data__	
WH3_ACHIEVEMENT_CATHAY_RECRUIT_TERRACOTTA_SENTINEL	WH3_ACHIEVEMENT_CATHAY_RECRUIT_TERRACOTTA_SENTINEL
WH3_ACHIEVEMENT_KHORNE_RECRUIT_BLOODTHIRSTER	WH3_ACHIEVEMENT_KHORNE_RECRUIT_BLOODTHIRSTER
WH3_ACHIEVEMENT_KISLEV_RECRUIT_ELEMENTAL_BEAR	WH3_ACHIEVEMENT_KISLEV_RECRUIT_ELEMENTAL_BEAR
WH3_ACHIEVEMENT_NURGLE_RECRUIT_GREAT_UNCLEAN_ONE	WH3_ACHIEVEMENT_NURGLE_RECRUIT_GREAT_UNCLEAN_ONE
WH3_ACHIEVEMENT_SLAANESH_RECRUIT_KEEPER_OF_SECRETS	WH3_ACHIEVEMENT_SLAANESH_RECRUIT_KEEPER_OF_SECRETS
WH3_ACHIEVEMENT_TZEENTCH_RECRUIT_LORD_OF_CHANGE	WH3_ACHIEVEMENT_TZEENTCH_RECRUIT_LORD_OF_CHANGE
WH3_ACHIEVEMENT_WINNING_BEASTMEN_1	WH3_ACHIEVEMENT_WINNING_BEASTMEN
WH3_ACHIEVEMENT_WINNING_BEASTMEN_2	WH3_ACHIEVEMENT_WINNING_BEASTMEN
WH3_ACHIEVEMENT_WINNING_BRETONNIA_1	WH3_ACHIEVEMENT_WINNING_BRETONNIA
WH3_ACHIEVEMENT_WINNING_BRETONNIA_2	WH3_ACHIEVEMENT_WINNING_BRETONNIA
WH3_ACHIEVEMENT_WINNING_CATHAY_1	WH3_ACHIEVEMENT_WINNING_CATHAY
WH3_ACHIEVEMENT_WINNING_CATHAY_2	WH3_ACHIEVEMENT_WINNING_CATHAY
WH3_ACHIEVEMENT_WINNING_CHAOS_1	WH3_ACHIEVEMENT_WINNING_CHAOS
WH3_ACHIEVEMENT_WINNING_CHAOS_2	WH3_ACHIEVEMENT_WINNING_CHAOS
WH3_ACHIEVEMENT_WINNING_CHAOS_DWARFS_1	WH3_ACHIEVEMENT_WINNING_CHAOS_DWARFS
WH3_ACHIEVEMENT_WINNING_CHAOS_DWARFS_2	WH3_ACHIEVEMENT_WINNING_CHAOS_DWARFS
WH3_ACHIEVEMENT_WINNING_DAEMON_PRINCE_1	WH3_ACHIEVEMENT_WINNING_DAEMON_PRINCE
WH3_ACHIEVEMENT_WINNING_DAEMON_PRINCE_2	WH3_ACHIEVEMENT_WINNING_DAEMON_PRINCE
WH3_ACHIEVEMENT_WINNING_DARK_ELVES_1	WH3_ACHIEVEMENT_WINNING_DARK_ELVES
WH3_ACHIEVEMENT_WINNING_DARK_ELVES_2	WH3_ACHIEVEMENT_WINNING_DARK_ELVES
WH3_ACHIEVEMENT_WINNING_DWARFS_1	WH3_ACHIEVEMENT_WINNING_DWARFS
WH3_ACHIEVEMENT_WINNING_DWARFS_2	WH3_ACHIEVEMENT_WINNING_DWARFS
WH3_ACHIEVEMENT_WINNING_EMPIRE_1	WH3_ACHIEVEMENT_WINNING_EMPIRE
WH3_ACHIEVEMENT_WINNING_EMPIRE_2	WH3_ACHIEVEMENT_WINNING_EMPIRE
WH3_ACHIEVEMENT_WINNING_GREENSKINS_1	WH3_ACHIEVEMENT_WINNING_GREENSKINS
WH3_ACHIEVEMENT_WINNING_GREENSKINS_2	WH3_ACHIEVEMENT_WINNING_GREENSKINS
WH3_ACHIEVEMENT_WINNING_HIGH_ELVES_1	WH3_ACHIEVEMENT_WINNING_HIGH_ELVES
WH3_ACHIEVEMENT_WINNING_HIGH_ELVES_2	WH3_ACHIEVEMENT_WINNING_HIGH_ELVES
WH3_ACHIEVEMENT_WINNING_KHORNE_1	WH3_ACHIEVEMENT_WINNING_KHORNE
WH3_ACHIEVEMENT_WINNING_KHORNE_2	WH3_ACHIEVEMENT_WINNING_KHORNE
WH3_ACHIEVEMENT_WINNING_KISLEV_1	WH3_ACHIEVEMENT_WINNING_KISLEV
WH3_ACHIEVEMENT_WINNING_KISLEV_2	WH3_ACHIEVEMENT_WINNING_KISLEV
WH3_ACHIEVEMENT_WINNING_LIZARDMEN_1	WH3_ACHIEVEMENT_WINNING_LIZARDMEN
WH3_ACHIEVEMENT_WINNING_LIZARDMEN_2	WH3_ACHIEVEMENT_WINNING_LIZARDMEN
WH3_ACHIEVEMENT_WINNING_NORSCA_1	WH3_ACHIEVEMENT_WINNING_NORSCA
WH3_ACHIEVEMENT_WINNING_NORSCA_2	WH3_ACHIEVEMENT_WINNING_NORSCA
WH3_ACHIEVEMENT_WINNING_NURGLE_1	WH3_ACHIEVEMENT_WINNING_NURGLE
WH3_ACHIEVEMENT_WINNING_NURGLE_2	WH3_ACHIEVEMENT_WINNING_NURGLE
WH3_ACHIEVEMENT_WINNING_OGRES_1	WH3_ACHIEVEMENT_WINNING_OGRES
WH3_ACHIEVEMENT_WINNING_OGRES_2	WH3_ACHIEVEMENT_WINNING_OGRES
WH3_ACHIEVEMENT_WINNING_SKAVEN_1	WH3_ACHIEVEMENT_WINNING_SKAVEN
WH3_ACHIEVEMENT_WINNING_SKAVEN_2	WH3_ACHIEVEMENT_WINNING_SKAVEN
WH3_ACHIEVEMENT_WINNING_SLAANESH_1	WH3_ACHIEVEMENT_WINNING_SLAANESH
WH3_ACHIEVEMENT_WINNING_SLAANESH_2	WH3_ACHIEVEMENT_WINNING_SLAANESH
WH3_ACHIEVEMENT_WINNING_TOMB_KINGS_1	WH3_ACHIEVEMENT_WINNING_TOMB_KINGS
WH3_ACHIEVEMENT_WINNING_TOMB_KINGS_2	WH3_ACHIEVEMENT_WINNING_TOMB_KINGS
WH3_ACHIEVEMENT_WINNING_TZEENTCH_1	WH3_ACHIEVEMENT_WINNING_TZEENTCH
WH3_ACHIEVEMENT_WINNING_TZEENTCH_2	WH3_ACHIEVEMENT_WINNING_TZEENTCH
WH3_ACHIEVEMENT_WINNING_VAMPIRE_COAST_1	WH3_ACHIEVEMENT_WINNING_VAMPIRE_COAST
WH3_ACHIEVEMENT_WINNING_VAMPIRE_COAST_2	WH3_ACHIEVEMENT_WINNING_VAMPIRE_COAST
WH3_ACHIEVEMENT_WINNING_VAMPIRE_COUNTS_1	WH3_ACHIEVEMENT_WINNING_VAMPIRE_COUNTS
WH3_ACHIEVEMENT_WINNING_VAMPIRE_COUNTS_2	WH3_ACHIEVEMENT_WINNING_VAMPIRE_COUNTS
WH3_ACHIEVEMENT_WINNING_WOOD_ELVES_1	WH3_ACHIEVEMENT_WINNING_WOOD_ELVES
WH3_ACHIEVEMENT_WINNING_WOOD_ELVES_2	WH3_ACHIEVEMENT_WINNING_WOOD_ELVES
