settlement_id	climate_type	citybar_height_offset	rotation
#campaign_map_settlements_tables;5;db/campaign_map_settlements_tables/data__			
settlement:settlement:wh3_main_combi_region_the_copper_landing	climate_desert	0	0
settlement:wh3_dlc20_chaos_region_black_pit	climate_temperate	0	0
settlement:wh3_dlc20_chaos_region_chantillon	climate_temperate	0	37
settlement:wh3_dlc20_chaos_region_citadel_of_lead	climate_frozen	0	0
settlement:wh3_dlc20_chaos_region_fort_sollace	climate_temperate	0	52
settlement:wh3_dlc20_chaos_region_grung_zint	climate_mountain	0	36
settlement:wh3_dlc20_chaos_region_losteriksons_landing	climate_frozen	0	0
settlement:wh3_dlc20_chaos_region_neuland	climate_frozen	0	331
settlement:wh3_dlc20_chaos_region_tancred_castle	climate_temperate	0	0
settlement:wh3_dlc20_chaos_region_wreckers_point	climate_temperate	0	11
settlement:wh3_dlc20_combi_region_glacial_gardens	climate_chaotic	0	0
settlement:wh3_dlc20_combi_region_glacier_encampment	climate_chaotic	0	0
settlement:wh3_dlc20_combi_region_krudenwald	climate_temperate	0	0
settlement:wh3_main_chaos_region_altar_of_spawns	climate_frozen	0	6
settlement:wh3_main_chaos_region_altar_of_the_crimson_harvest	climate_frozen	0	0
settlement:wh3_main_chaos_region_altdorf	climate_temperate	0	0
settlement:wh3_main_chaos_region_amblepeak	climate_mountain	0	0
settlement:wh3_main_chaos_region_bay_of_blades	climate_frozen	0	0
settlement:wh3_main_chaos_region_bechafen	climate_temperate	0	84
settlement:wh3_main_chaos_region_black_fang	climate_mountain	0	0
settlement:wh3_main_chaos_region_black_fortress	climate_wasteland	0	0
settlement:wh3_main_chaos_region_black_gulch	climate_frozen	0	0
settlement:wh3_main_chaos_region_black_rock	climate_chaotic	0	0
settlement:wh3_main_chaos_region_blackstone_tower	climate_mountain	0	283
settlement:wh3_main_chaos_region_blizzardpeak	climate_frozen	0	0
settlement:wh3_main_chaos_region_blood_haven	climate_chaotic	0	0
settlement:wh3_main_chaos_region_blood_mountain	climate_chaotic	0	0
settlement:wh3_main_chaos_region_bloodpeak	climate_mountain	0	0
settlement:wh3_main_chaos_region_bloodwind_keep	climate_chaotic	0	0
settlement:wh3_main_chaos_region_bohsenfels	climate_temperate	0	114
settlement:wh3_main_chaos_region_bolgasgrad	climate_temperate	0	114
settlement:wh3_main_chaos_region_brass_keep	climate_mountain	0	0
settlement:wh3_main_chaos_region_bridge_of_brass	climate_chaotic	0	0
settlement:wh3_main_chaos_region_bridge_of_heaven	climate_savannah	0	0
settlement:wh3_main_chaos_region_broekwater	climate_temperate	0	124
settlement:wh3_main_chaos_region_castle_alexandronov	climate_frozen	0	0
settlement:wh3_main_chaos_region_castle_drachenfels	climate_mountain	0	132
settlement:wh3_main_chaos_region_castle_drakenhof	climate_temperate	0	88
settlement:wh3_main_chaos_region_chasm_of_torment	climate_chaotic	0	0
settlement:wh3_main_chaos_region_chimera_plateau	climate_chaotic	0	0
settlement:wh3_main_chaos_region_city_of_monkeys	climate_desert	0	121
settlement:wh3_main_chaos_region_city_of_splinters	climate_chaotic	0	152
settlement:wh3_main_chaos_region_city_of_the_shugengan	climate_temperate	0	0
settlement:wh3_main_chaos_region_cliff_of_beasts	climate_chaotic	0	0
settlement:wh3_main_chaos_region_crookback_mountain	climate_mountain	0	0
settlement:wh3_main_chaos_region_darkhold	climate_wasteland	0	0
settlement:wh3_main_chaos_region_delberz	climate_temperate	0	38
settlement:wh3_main_chaos_region_dharko_wharf	climate_chaotic	0	334
settlement:wh3_main_chaos_region_dhazhyn	climate_frozen	0	202
settlement:wh3_main_chaos_region_dietershafen	climate_temperate	0	357
settlement:wh3_main_chaos_region_doomkeep	climate_frozen	0	0
settlement:wh3_main_chaos_region_dragon_fang_mount	climate_jungle	0	0
settlement:wh3_main_chaos_region_dragon_gate	climate_temperate	0	276
settlement:wh3_main_chaos_region_dragons_crossroad	climate_chaotic	0	0
settlement:wh3_main_chaos_region_dragons_death	climate_chaotic	0	0
settlement:wh3_main_chaos_region_dushyka	climate_temperate	0	251
settlement:wh3_main_chaos_region_eagle_eyries	climate_mountain	0	0
settlement:wh3_main_chaos_region_eilhart	climate_temperate	0	0
settlement:wh3_main_chaos_region_erengrad	climate_temperate	0	14
settlement:wh3_main_chaos_region_fallen_city	climate_mountain	0	0
settlement:wh3_main_chaos_region_fire_mouth	climate_mountain	0	0
settlement:wh3_main_chaos_region_floating_mountain	climate_wasteland	0	0
settlement:wh3_main_chaos_region_fort_bergbres	climate_temperate	0	283
settlement:wh3_main_chaos_region_fort_dolganyeir	climate_wasteland	0	171
settlement:wh3_main_chaos_region_fort_dorznye_vort	climate_wasteland	0	158
settlement:wh3_main_chaos_region_fort_jakova	climate_temperate	0	209
settlement:wh3_main_chaos_region_fort_ostrosk	climate_temperate	0	0
settlement:wh3_main_chaos_region_fort_straghov	climate_mountain	0	144
settlement:wh3_main_chaos_region_fortenhof	climate_temperate	0	201
settlement:wh3_main_chaos_region_fortress_of_eyes	climate_chaotic	0	0
settlement:wh3_main_chaos_region_fortress_of_the_damned	climate_chaotic	0	0
settlement:wh3_main_chaos_region_foul_fortress	climate_frozen	0	1
settlement:wh3_main_chaos_region_foundry_of_bones	climate_chaotic	0	0
settlement:wh3_main_chaos_region_frozen_landing	climate_frozen	0	54
settlement:wh3_main_chaos_region_gerslev	climate_temperate	0	189
settlement:wh3_main_chaos_region_glut_port	climate_chaotic	0	328
settlement:wh3_main_chaos_region_gnashraks_lair	climate_mountain	0	45
settlement:wh3_main_chaos_region_gorger_rock	climate_mountain	0	0
settlement:wh3_main_chaos_region_gorssel	climate_temperate	0	109
settlement:wh3_main_chaos_region_graeling_moot	climate_frozen	0	32
settlement:wh3_main_chaos_region_granite_spikes	climate_mountain	0	0
settlement:wh3_main_chaos_region_great_hall_of_greasus	climate_mountain	0	0
settlement:wh3_main_chaos_region_great_skull_lakes	climate_wasteland	0	0
settlement:wh3_main_chaos_region_grim_duraz	climate_mountain	0	0
settlement:wh3_main_chaos_region_grimtop	climate_mountain	0	0
settlement:wh3_main_chaos_region_grissenwald	climate_temperate	0	20
settlement:wh3_main_chaos_region_gristle_valley	climate_mountain	0	322
settlement:wh3_main_chaos_region_hanyu_port	climate_savannah	0	156
settlement:wh3_main_chaos_region_hell_pit	climate_wasteland	0	17
settlement:wh3_main_chaos_region_hellcade_drove	climate_chaotic	0	0
settlement:wh3_main_chaos_region_hergig	climate_temperate	0	70
settlement:wh3_main_chaos_region_hissing_pits	climate_mountain	0	0
settlement:wh3_main_chaos_region_howling_rock	climate_wasteland	0	0
settlement:wh3_main_chaos_region_ice_caverns_of_ymirdrak	climate_frozen	0	0
settlement:wh3_main_chaos_region_icedrake_fjord	climate_frozen	0	30
settlement:wh3_main_chaos_region_icespewer	climate_frozen	0	25
settlement:wh3_main_chaos_region_igerov	climate_temperate	0	273
settlement:wh3_main_chaos_region_infernius	climate_chaotic	0	0
settlement:wh3_main_chaos_region_iron_storm	climate_chaotic	0	0
settlement:wh3_main_chaos_region_jade_wind_mountain	climate_mountain	0	0
settlement:wh3_main_chaos_region_karak_azgaraz	climate_mountain	0	250
settlement:wh3_main_chaos_region_karak_azorn	climate_mountain	0	348
settlement:wh3_main_chaos_region_karak_dum	climate_mountain	0	0
settlement:wh3_main_chaos_region_karak_kadrin	climate_mountain	0	352
settlement:wh3_main_chaos_region_karak_krakaten	climate_mountain	0	0
settlement:wh3_main_chaos_region_karak_raziak	climate_mountain	0	0
settlement:wh3_main_chaos_region_karak_ungor	climate_mountain	0	0
settlement:wh3_main_chaos_region_karak_vlag	climate_mountain	0	0
settlement:wh3_main_chaos_region_karak_vrag	climate_mountain	0	0
settlement:wh3_main_chaos_region_karak_ziflin	climate_mountain	0	34
settlement:wh3_main_chaos_region_khazid_irkulaz	climate_mountain	0	0
settlement:wh3_main_chaos_region_kislev	climate_temperate	0	127
settlement:wh3_main_chaos_region_konigstein_tower	climate_temperate	0	0
settlement:wh3_main_chaos_region_kraka_dorden	climate_mountain	0	0
settlement:wh3_main_chaos_region_kraka_drak	climate_mountain	0	315
settlement:wh3_main_chaos_region_kraz_und	climate_mountain	0	224
settlement:wh3_main_chaos_region_krudenwald	climate_temperate	0	0
settlement:wh3_main_chaos_region_kunlan	climate_mountain	0	0
settlement:wh3_main_chaos_region_kurak_peak	climate_mountain	0	0
settlement:wh3_main_chaos_region_kusel	climate_temperate	0	0
settlement:wh3_main_chaos_region_laurelorn_forest	climate_magicforest	0	0
settlement:wh3_main_chaos_region_leblya	climate_frozen	0	0
settlement:wh3_main_chaos_region_longship_graveyard	climate_frozen	0	0
settlement:wh3_main_chaos_region_marienburg	climate_temperate	0	347
settlement:wh3_main_chaos_region_middenheim	climate_temperate	0	217
settlement:wh3_main_chaos_region_mines_of_gorgoth	climate_mountain	0	0
settlement:wh3_main_chaos_region_mines_of_nan_yang	climate_savannah	0	154
settlement:wh3_main_chaos_region_ming_zhu	climate_temperate	0	0
settlement:wh3_main_chaos_region_mist_gorge	climate_mountain	0	0
settlement:wh3_main_chaos_region_mount_cragg	climate_mountain	0	0
settlement:wh3_main_chaos_region_mount_grey_hag	climate_mountain	0	0
settlement:wh3_main_chaos_region_mount_grimfang	climate_mountain	0	0
settlement:wh3_main_chaos_region_mount_gunbad	climate_mountain	0	0
settlement:wh3_main_chaos_region_mount_thug	climate_mountain	0	0
settlement:wh3_main_chaos_region_nan_gau	climate_savannah	0	337
settlement:wh3_main_chaos_region_nan_li	climate_desert	0	158
settlement:wh3_main_chaos_region_nongchang	climate_savannah	0	0
settlement:wh3_main_chaos_region_norden	climate_temperate	0	359
settlement:wh3_main_chaos_region_novchozy	climate_frozen	0	0
settlement:wh3_main_chaos_region_nuln	climate_temperate	0	201
settlement:wh3_main_chaos_region_oakenhammer	climate_mountain	0	229
settlement:wh3_main_chaos_region_osterwald	climate_temperate	0	0
settlement:wh3_main_chaos_region_pack_ice_bay	climate_frozen	0	35
settlement:wh3_main_chaos_region_palace_of_princes	climate_chaotic	0	0
settlement:wh3_main_chaos_region_pigbarter	climate_temperate	0	0
settlement:wh3_main_chaos_region_pillar_of_skulls	climate_chaotic	0	0
settlement:wh3_main_chaos_region_plesk	climate_frozen	0	123
settlement:wh3_main_chaos_region_po_mei	climate_savannah	0	78
settlement:wh3_main_chaos_region_praag	climate_frozen	0	119
settlement:wh3_main_chaos_region_qiang	climate_desert	0	0
settlement:wh3_main_chaos_region_red_fortress	climate_chaotic	0	0
settlement:wh3_main_chaos_region_rosche	climate_temperate	0	90
settlement:wh3_main_chaos_region_sabre_mountain	climate_mountain	0	0
settlement:wh3_main_chaos_region_salzenmund	climate_temperate	0	101
settlement:wh3_main_chaos_region_seep_gore	climate_mountain	0	0
settlement:wh3_main_chaos_region_sepukzy	climate_frozen	0	177
settlement:wh3_main_chaos_region_serpent_jetty	climate_frozen	0	17
settlement:wh3_main_chaos_region_shambletown	climate_mountain	0	0
settlement:wh3_main_chaos_region_shang_wu	climate_savannah	0	67
settlement:wh3_main_chaos_region_shang_yang	climate_desert	0	0
settlement:wh3_main_chaos_region_shattered_stone_bay	climate_temperate	0	359
settlement:wh3_main_chaos_region_shi_long	climate_savannah	0	137
settlement:wh3_main_chaos_region_shrine_of_the_alchemist	climate_desert	0	351
settlement:wh3_main_chaos_region_siegfriedhof	climate_temperate	0	115
settlement:wh3_main_chaos_region_sjoktraken	climate_frozen	0	0
settlement:wh3_main_chaos_region_skrap_towers	climate_temperate	0	0
settlement:wh3_main_chaos_region_snake_gate	climate_temperate	0	285
settlement:wh3_main_chaos_region_stormvrack_mount	climate_wasteland	0	0
settlement:wh3_main_chaos_region_tai_tzu	climate_desert	0	198
settlement:wh3_main_chaos_region_talabheim	climate_temperate	0	11
settlement:wh3_main_chaos_region_temple_of_elemental_winds	climate_savannah	0	0
settlement:wh3_main_chaos_region_temple_of_heimkel	climate_frozen	0	0
settlement:wh3_main_chaos_region_terracotta_graveyard	climate_savannah	0	20
settlement:wh3_main_chaos_region_the_bleeding_spire	climate_chaotic	0	0
settlement:wh3_main_chaos_region_the_blighted_grove	climate_chaotic	0	0
settlement:wh3_main_chaos_region_the_brass_glacier	climate_chaotic	0	0
settlement:wh3_main_chaos_region_the_burning_monolith	climate_chaotic	0	0
settlement:wh3_main_chaos_region_the_challenge_stone	climate_chaotic	0	0
settlement:wh3_main_chaos_region_the_crystal_spires	climate_chaotic	0	0
settlement:wh3_main_chaos_region_the_daemons_stump	climate_wasteland	0	0
settlement:wh3_main_chaos_region_the_falls_of_doom	climate_wasteland	0	0
settlement:wh3_main_chaos_region_the_fetid_catacombs	climate_chaotic	0	0
settlement:wh3_main_chaos_region_the_folly_of_malofex	climate_chaotic	0	0
settlement:wh3_main_chaos_region_the_forbidden_citadel	climate_frozen	0	2
settlement:wh3_main_chaos_region_the_forest_of_decay	climate_chaotic	0	0
settlement:wh3_main_chaos_region_the_fortress_of_vorag	climate_wasteland	0	0
settlement:wh3_main_chaos_region_the_gallows_tree	climate_chaotic	0	135
settlement:wh3_main_chaos_region_the_gates_of_zharr	climate_wasteland	0	0
settlement:wh3_main_chaos_region_the_howling_citadel	climate_chaotic	0	0
settlement:wh3_main_chaos_region_the_last_sky_castle	climate_mountain	0	0
settlement:wh3_main_chaos_region_the_monolith_of_katam	climate_frozen	0	0
settlement:wh3_main_chaos_region_the_monolith_of_kjarl_deathaxe	climate_chaotic	0	0
settlement:wh3_main_chaos_region_the_monolith_of_the_void	climate_chaotic	0	0
settlement:wh3_main_chaos_region_the_palace_of_ruin	climate_chaotic	0	0
settlement:wh3_main_chaos_region_the_red_abyss	climate_chaotic	0	0
settlement:wh3_main_chaos_region_the_sentinels	climate_wasteland	0	0
settlement:wh3_main_chaos_region_the_shifting_monolith	climate_chaotic	0	0
settlement:wh3_main_chaos_region_the_silver_pinnacle	climate_mountain	0	0
settlement:wh3_main_chaos_region_the_silvered_tower_of_sorcerers	climate_chaotic	0	0
settlement:wh3_main_chaos_region_the_sky_monolith	climate_mountain	0	0
settlement:wh3_main_chaos_region_the_sunken_sewers	climate_chaotic	0	0
settlement:wh3_main_chaos_region_the_tower_of_flies	climate_chaotic	0	0
settlement:wh3_main_chaos_region_the_tower_of_gorgoth	climate_mountain	0	162
settlement:wh3_main_chaos_region_the_tower_of_khrakk	climate_frozen	0	0
settlement:wh3_main_chaos_region_the_tower_of_torment	climate_chaotic	0	0
settlement:wh3_main_chaos_region_the_twisted_towers	climate_chaotic	0	0
settlement:wh3_main_chaos_region_the_vale_of_nightmares	climate_chaotic	0	0
settlement:wh3_main_chaos_region_the_volary	climate_chaotic	0	187
settlement:wh3_main_chaos_region_the_writhing_fortress	climate_chaotic	0	0
settlement:wh3_main_chaos_region_titans_notch	climate_mountain	0	0
settlement:wh3_main_chaos_region_tower_of_ashshair	climate_desert	0	359
settlement:wh3_main_chaos_region_tower_of_grief	climate_wasteland	0	0
settlement:wh3_main_chaos_region_tree_of_damned_shades	climate_chaotic	0	0
settlement:wh3_main_chaos_region_troll_fjord	climate_frozen	0	12
settlement:wh3_main_chaos_region_turtle_gate	climate_temperate	0	281
settlement:wh3_main_chaos_region_ubersreik	climate_temperate	0	139
settlement:wh3_main_chaos_region_uzkulak	climate_wasteland	0	15
settlement:wh3_main_chaos_region_uzkulany	climate_wasteland	0	0
settlement:wh3_main_chaos_region_vale_of_titans	climate_mountain	0	0
settlement:wh3_main_chaos_region_village_of_the_moon	climate_temperate	0	0
settlement:wh3_main_chaos_region_village_of_the_tigermen	climate_desert	0	82
settlement:wh3_main_chaos_region_volcanos_heart	climate_chaotic	0	0
settlement:wh3_main_chaos_region_volksgrad	climate_frozen	0	89
settlement:wh3_main_chaos_region_waldenhof	climate_temperate	0	0
settlement:wh3_main_chaos_region_wei_jin	climate_temperate	0	12
settlement:wh3_main_chaos_region_weng_chang	climate_desert	0	204
settlement:wh3_main_chaos_region_winter_pyre	climate_frozen	0	0
settlement:wh3_main_chaos_region_wolfenburg	climate_temperate	0	196
settlement:wh3_main_chaos_region_wurtbad	climate_temperate	0	210
settlement:wh3_main_chaos_region_wurzen	climate_temperate	0	0
settlement:wh3_main_chaos_region_xen_wu	climate_desert	0	1
settlement:wh3_main_chaos_region_xing_po	climate_temperate	0	0
settlement:wh3_main_chaos_region_yetchitch	climate_frozen	0	131
settlement:wh3_main_chaos_region_yhetee_peak	climate_mountain	0	0
settlement:wh3_main_chaos_region_zamoski	climate_wasteland	0	0
settlement:wh3_main_chaos_region_zanbaijin	climate_chaotic	0	0
settlement:wh3_main_chaos_region_zerulous	climate_chaotic	0	0
settlement:wh3_main_chaos_region_zhanshi	climate_temperate	0	0
settlement:wh3_main_chaos_region_zharr_naggrund	climate_wasteland	0	0
settlement:wh3_main_chaos_region_zhufbar	climate_mountain	0	321
settlement:wh3_main_chaos_region_zoishenk	climate_frozen	0	76
settlement:wh3_main_combi_region_aarnau	climate_temperate	0	0
settlement:wh3_main_combi_region_agrul_migdhal	climate_wasteland	0	0
settlement:wh3_main_combi_region_akendorf	climate_temperate	0	170
settlement:wh3_main_combi_region_al_haikk	climate_desert	0	38
settlement:wh3_main_combi_region_altar_of_facades	climate_chaotic	0	138
settlement:wh3_main_combi_region_altar_of_spawns	climate_chaotic	0	0
settlement:wh3_main_combi_region_altar_of_the_bloody_harvest	climate_frozen	0	0
settlement:wh3_main_combi_region_altar_of_the_horned_rat	climate_jungle	0	0
settlement:wh3_main_combi_region_altar_of_ultimate_darkness	climate_frozen	0	0
settlement:wh3_main_combi_region_altdorf	climate_temperate	0	0
settlement:wh3_main_combi_region_amblepeak	climate_mountain	0	0
settlement:wh3_main_combi_region_ancient_city_of_quintex	climate_frozen	0	30
settlement:wh3_main_combi_region_angerrial	climate_island	0	0
settlement:wh3_main_combi_region_antoch	climate_desert	0	25
settlement:wh3_main_combi_region_aquitaine	climate_temperate	0	0
settlement:wh3_main_combi_region_argalis	climate_temperate	0	0
settlement:wh3_main_combi_region_arnheim	climate_frozen	0	336
settlement:wh3_main_combi_region_ash_ridge_mountains	climate_mountain	0	224
settlement:wh3_main_combi_region_ashrak	climate_frozen	0	84
settlement:wh3_main_combi_region_averheim	climate_temperate	0	0
settlement:wh3_main_combi_region_avethir	climate_island	0	347
settlement:wh3_main_combi_region_axlotl	climate_jungle	0	0
settlement:wh3_main_combi_region_baleful_hills	climate_savannah	0	181
settlement:wh3_main_combi_region_bamboo_crossing	climate_temperate	0	0
settlement:wh3_main_combi_region_barag_dawazbag	climate_wasteland	0	0
settlement:wh3_main_combi_region_barak_varr	climate_mountain	0	338
settlement:wh3_main_combi_region_bay_of_blades	climate_frozen	0	0
settlement:wh3_main_combi_region_bechafen	climate_temperate	0	0
settlement:wh3_main_combi_region_beichai	climate_temperate	0	0
settlement:wh3_main_combi_region_bhagar	climate_desert	0	0
settlement:wh3_main_combi_region_bilbali	climate_temperate	0	41
settlement:wh3_main_combi_region_bilious_cliffs	climate_chaotic	0	0
settlement:wh3_main_combi_region_bitter_bay	climate_wasteland	0	0
settlement:wh3_main_combi_region_bitterstone_mine	climate_wasteland	0	0
settlement:wh3_main_combi_region_black_crag	climate_mountain	0	304
settlement:wh3_main_combi_region_black_creek_spire	climate_frozen	0	0
settlement:wh3_main_combi_region_black_fang	climate_mountain	0	325
settlement:wh3_main_combi_region_black_fortress	climate_wasteland	0	0
settlement:wh3_main_combi_region_black_iron_mine	climate_mountain	0	0
settlement:wh3_main_combi_region_black_pyramid_of_nagash	climate_desert	0	356
settlement:wh3_main_combi_region_black_rock	climate_chaotic	0	0
settlement:wh3_main_combi_region_black_tower_of_arkhan	climate_desert	0	29
settlement:wh3_main_combi_region_blacklight_tower	climate_frozen	0	23
settlement:wh3_main_combi_region_blackstone_post	climate_mountain	0	102
settlement:wh3_main_combi_region_bleak_hold_fortress	climate_frozen	0	0
settlement:wh3_main_combi_region_blizzardpeak	climate_frozen	0	0
settlement:wh3_main_combi_region_blood_mountain	climate_chaotic	0	0
settlement:wh3_main_combi_region_bloodpeak	climate_mountain	0	332
settlement:wh3_main_combi_region_bloodwind_keep	climate_chaotic	0	0
settlement:wh3_main_combi_region_bordeleaux	climate_temperate	0	4
settlement:wh3_main_combi_region_brass_keep	climate_mountain	0	0
settlement:wh3_main_combi_region_bridge_of_heaven	climate_savannah	0	0
settlement:wh3_main_combi_region_brionne	climate_temperate	0	0
settlement:wh3_main_combi_region_cairn_thel	climate_island	0	0
settlement:wh3_main_combi_region_carroburg	climate_temperate	0	0
settlement:wh3_main_combi_region_castle_alexandronov	climate_frozen	0	0
settlement:wh3_main_combi_region_castle_artois	climate_temperate	0	156
settlement:wh3_main_combi_region_castle_bastonne	climate_temperate	0	89
settlement:wh3_main_combi_region_castle_carcassonne	climate_temperate	0	151
settlement:wh3_main_combi_region_castle_drakenhof	climate_temperate	0	0
settlement:wh3_main_combi_region_castle_of_splendour	climate_chaotic	0	352
settlement:wh3_main_combi_region_castle_templehof	climate_temperate	0	0
settlement:wh3_main_combi_region_castle_von_rauken	climate_temperate	0	52
settlement:wh3_main_combi_region_caverns_of_sotek	climate_jungle	0	0
settlement:wh3_main_combi_region_celestial_monastery	climate_temperate	0	0
settlement:wh3_main_combi_region_chamber_of_visions	climate_jungle	0	0
settlement:wh3_main_combi_region_chaqua	climate_jungle	0	0
settlement:wh3_main_combi_region_chill_road	climate_frozen	0	0
settlement:wh3_main_combi_region_chimai	climate_temperate	0	0
settlement:wh3_main_combi_region_chupayotl	climate_savannah	0	0
settlement:wh3_main_combi_region_circle_of_destruction	climate_frozen	0	331
settlement:wh3_main_combi_region_citadel_of_dusk	climate_savannah	0	0
settlement:wh3_main_combi_region_citadel_of_lead	climate_frozen	0	0
settlement:wh3_main_combi_region_city_of_the_shugengan	climate_temperate	0	142
settlement:wh3_main_combi_region_clar_karond	climate_frozen	0	0
settlement:wh3_main_combi_region_clarak_spire	climate_wasteland	0	0
settlement:wh3_main_combi_region_cliff_of_beasts	climate_chaotic	0	0
settlement:wh3_main_combi_region_copher	climate_desert	0	32
settlement:wh3_main_combi_region_couronne	climate_temperate	0	151
settlement:wh3_main_combi_region_crag_halls_of_findol	climate_magicforest	0	0
settlement:wh3_main_combi_region_cragroth_deep	climate_mountain	0	0
settlement:wh3_main_combi_region_crookback_mountain	climate_mountain	0	0
settlement:wh3_main_combi_region_crooked_fang_fort	climate_mountain	0	0
settlement:wh3_main_combi_region_crucible_of_delights	climate_chaotic	0	0
settlement:wh3_main_combi_region_cuexotl	climate_jungle	0	0
settlement:wh3_main_combi_region_daemons_gate	climate_chaotic	0	0
settlement:wh3_main_combi_region_dagraks_end	climate_chaotic	0	0
settlement:wh3_main_combi_region_dai_cheng	climate_temperate	0	359
settlement:wh3_main_combi_region_dargoth	climate_frozen	0	0
settlement:wh3_main_combi_region_darkhold	climate_wasteland	0	0
settlement:wh3_main_combi_region_deff_gorge	climate_mountain	0	0
settlement:wh3_main_combi_region_desolation_of_drakenmoor	climate_wasteland	0	161
settlement:wh3_main_combi_region_desolation_of_nagash	climate_wasteland	0	0
settlement:wh3_main_combi_region_dietershafen	climate_temperate	0	0
settlement:wh3_main_combi_region_dok_karaz	climate_wasteland	0	0
settlement:wh3_main_combi_region_doom_glade	climate_desert	0	145
settlement:wh3_main_combi_region_doomkeep	climate_chaotic	0	0
settlement:wh3_main_combi_region_dotternbach	climate_temperate	0	0
settlement:wh3_main_combi_region_drackla_spire	climate_mountain	0	70
settlement:wh3_main_combi_region_dragon_fang_mount	climate_jungle	0	0
settlement:wh3_main_combi_region_dragon_gate	climate_temperate	0	0
settlement:wh3_main_combi_region_dragonhorn_mines	climate_wasteland	0	0
settlement:wh3_main_combi_region_dragons_crossroad	climate_chaotic	0	0
settlement:wh3_main_combi_region_dragons_death	climate_chaotic	0	0
settlement:wh3_main_combi_region_dread_rock	climate_jungle	0	0
settlement:wh3_main_combi_region_dringorackaz	climate_mountain	0	278
settlement:wh3_main_combi_region_dusk_peaks	climate_savannah	0	0
settlement:wh3_main_combi_region_eagle_eyries	climate_mountain	0	0
settlement:wh3_main_combi_region_eagle_gate	climate_island	0	273
settlement:wh3_main_combi_region_eilhart	climate_temperate	0	0
settlement:wh3_main_combi_region_ekrund	climate_wasteland	0	0
settlement:wh3_main_combi_region_el_kalabad	climate_desert	0	0
settlement:wh3_main_combi_region_eldar_spire	climate_mountain	0	0
settlement:wh3_main_combi_region_elessaeli	climate_island	0	350
settlement:wh3_main_combi_region_elisia	climate_island	0	358
settlement:wh3_main_combi_region_erengrad	climate_temperate	0	0
settlement:wh3_main_combi_region_eschen	climate_temperate	0	0
settlement:wh3_main_combi_region_essen	climate_temperate	0	0
settlement:wh3_main_combi_region_evershale	climate_island	0	341
settlement:wh3_main_combi_region_eye_of_the_panther	climate_mountain	0	214
settlement:wh3_main_combi_region_fallen_gates	climate_savannah	0	0
settlement:wh3_main_combi_region_fallen_king_mountain	climate_mountain	0	180
settlement:wh3_main_combi_region_fateweavers_crevasse	climate_chaotic	0	212
settlement:wh3_main_combi_region_fire_mouth	climate_mountain	0	14
settlement:wh3_main_combi_region_flayed_rock	climate_mountain	0	0
settlement:wh3_main_combi_region_flensburg	climate_temperate	0	0
settlement:wh3_main_combi_region_floating_mountain	climate_chaotic	0	0
settlement:wh3_main_combi_region_floating_pyramid	climate_jungle	0	0
settlement:wh3_main_combi_region_floating_village	climate_wasteland	0	0
settlement:wh3_main_combi_region_forest_of_arnheim	climate_frozen	0	130
settlement:wh3_main_combi_region_forest_of_gloom	climate_magicforest	0	0
settlement:wh3_main_combi_region_fort_bergbres	climate_temperate	0	159
settlement:wh3_main_combi_region_fort_jakova	climate_temperate	0	0
settlement:wh3_main_combi_region_fort_oberstyre	climate_temperate	0	0
settlement:wh3_main_combi_region_fort_ostrosk	climate_frozen	0	66
settlement:wh3_main_combi_region_fort_soll	climate_temperate	0	78
settlement:wh3_main_combi_region_fort_straghov	climate_frozen	0	9
settlement:wh3_main_combi_region_fortress_of_dawn	climate_island	0	0
settlement:wh3_main_combi_region_fortress_of_eyes	climate_chaotic	0	0
settlement:wh3_main_combi_region_fortress_of_the_damned	climate_chaotic	0	0
settlement:wh3_main_combi_region_foundry_of_bones	climate_chaotic	0	0
settlement:wh3_main_combi_region_frozen_landing	climate_frozen	0	0
settlement:wh3_main_combi_region_fu_chow	climate_temperate	0	0
settlement:wh3_main_combi_region_fu_hung	climate_temperate	0	359
settlement:wh3_main_combi_region_fuming_serpent	climate_jungle	0	0
settlement:wh3_main_combi_region_fyrus	climate_desert	0	119
settlement:wh3_main_combi_region_gaean_vale	climate_magicforest	0	0
settlement:wh3_main_combi_region_galbaraz	climate_wasteland	0	211
settlement:wh3_main_combi_region_ghrond	climate_frozen	0	0
settlement:wh3_main_combi_region_gisoreux	climate_temperate	0	0
settlement:wh3_main_combi_region_gnashraks_lair	climate_mountain	0	190
settlement:wh3_main_combi_region_gnobbly_gorge	climate_temperate	0	0
settlement:wh3_main_combi_region_golden_ziggurat	climate_island	0	0
settlement:wh3_main_combi_region_gor_gazan	climate_wasteland	0	0
settlement:wh3_main_combi_region_gorger_rock	climate_mountain	0	23
settlement:wh3_main_combi_region_gorssel	climate_temperate	0	0
settlement:wh3_main_combi_region_graeling_moot	climate_chaotic	0	0
settlement:wh3_main_combi_region_granite_massif	climate_mountain	0	224
settlement:wh3_main_combi_region_granite_spikes	climate_mountain	0	116
settlement:wh3_main_combi_region_great_desert_of_araby	climate_desert	0	342
settlement:wh3_main_combi_region_great_hall_of_greasus	climate_mountain	0	343
settlement:wh3_main_combi_region_great_skull_lakes	climate_wasteland	0	30
settlement:wh3_main_combi_region_great_turtle_isle	climate_island	0	0
settlement:wh3_main_combi_region_grenzstadt	climate_temperate	0	0
settlement:wh3_main_combi_region_grey_rock_point	climate_frozen	0	327
settlement:wh3_main_combi_region_griffon_gate	climate_island	0	291
settlement:wh3_main_combi_region_grimhold	climate_mountain	0	82
settlement:wh3_main_combi_region_grimtop	climate_mountain	0	26
settlement:wh3_main_combi_region_gristle_valley	climate_mountain	0	0
settlement:wh3_main_combi_region_grom_peak	climate_mountain	0	0
settlement:wh3_main_combi_region_gronti_mingol	climate_wasteland	0	0
settlement:wh3_main_combi_region_grotrilexs_glare_lighthouse	climate_chaotic	0	340
settlement:wh3_main_combi_region_grunburg	climate_temperate	0	0
settlement:wh3_main_combi_region_grung_zint	climate_mountain	0	0
settlement:wh3_main_combi_region_gryphon_wood	climate_magicforest	0	0
settlement:wh3_main_combi_region_hag_graef	climate_frozen	0	19
settlement:wh3_main_combi_region_hag_hall	climate_frozen	0	0
settlement:wh3_main_combi_region_haichai	climate_temperate	0	0
settlement:wh3_main_combi_region_hanyu_port	climate_temperate	0	0
settlement:wh3_main_combi_region_har_ganeth	climate_frozen	0	119
settlement:wh3_main_combi_region_har_kaldra	climate_frozen	0	0
settlement:wh3_main_combi_region_hell_pit	climate_wasteland	0	0
settlement:wh3_main_combi_region_helmgart	climate_temperate	0	110
settlement:wh3_main_combi_region_hergig	climate_temperate	0	0
settlement:wh3_main_combi_region_hexoatl	climate_jungle	0	0
settlement:wh3_main_combi_region_hoteks_column	climate_frozen	0	0
settlement:wh3_main_combi_region_howling_rock	climate_wasteland	0	0
settlement:wh3_main_combi_region_hualotal	climate_mountain	0	0
settlement:wh3_main_combi_region_ice_rock_gorge	climate_mountain	0	0
settlement:wh3_main_combi_region_icespewer	climate_frozen	0	0
settlement:wh3_main_combi_region_infernius	climate_chaotic	0	0
settlement:wh3_main_combi_region_iron_rock	climate_wasteland	0	343
settlement:wh3_main_combi_region_iron_storm	climate_chaotic	0	0
settlement:wh3_main_combi_region_ironfrost	climate_chaotic	0	0
settlement:wh3_main_combi_region_ironspike	climate_frozen	0	184
settlement:wh3_main_combi_region_isle_of_wights	climate_frozen	0	0
settlement:wh3_main_combi_region_itza	climate_jungle	0	0
settlement:wh3_main_combi_region_jade_wind_mountain	climate_temperate	0	0
settlement:wh3_main_combi_region_jungles_of_chian	climate_magicforest	0	0
settlement:wh3_main_combi_region_ka_sabar	climate_desert	0	1
settlement:wh3_main_combi_region_kaiax	climate_savannah	0	0
settlement:wh3_main_combi_region_kappelburg	climate_temperate	0	0
settlement:wh3_main_combi_region_karag_dromar	climate_mountain	0	76
settlement:wh3_main_combi_region_karag_dron	climate_mountain	0	187
settlement:wh3_main_combi_region_karag_orrud	climate_mountain	0	21
settlement:wh3_main_combi_region_karak_angazhar	climate_mountain	0	219
settlement:wh3_main_combi_region_karak_azgal	climate_mountain	0	0
settlement:wh3_main_combi_region_karak_azgaraz	climate_mountain	0	66
settlement:wh3_main_combi_region_karak_azorn	climate_mountain	0	316
settlement:wh3_main_combi_region_karak_azul	climate_mountain	0	52
settlement:wh3_main_combi_region_karak_bhufdar	climate_mountain	0	190
settlement:wh3_main_combi_region_karak_dum	climate_mountain	0	96
settlement:wh3_main_combi_region_karak_eight_peaks	climate_mountain	0	29
settlement:wh3_main_combi_region_karak_hirn	climate_mountain	0	244
settlement:wh3_main_combi_region_karak_izor	climate_mountain	0	225
settlement:wh3_main_combi_region_karak_kadrin	climate_mountain	0	24
settlement:wh3_main_combi_region_karak_krakaten	climate_mountain	0	330
settlement:wh3_main_combi_region_karak_norn	climate_mountain	0	254
settlement:wh3_main_combi_region_karak_raziak	climate_mountain	0	190
settlement:wh3_main_combi_region_karak_ungor	climate_mountain	0	0
settlement:wh3_main_combi_region_karak_vlag	climate_mountain	0	270
settlement:wh3_main_combi_region_karak_vrag	climate_mountain	0	0
settlement:wh3_main_combi_region_karak_ziflin	climate_mountain	0	325
settlement:wh3_main_combi_region_karak_zorn	climate_mountain	0	122
settlement:wh3_main_combi_region_karaz_a_karak	climate_mountain	0	0
settlement:wh3_main_combi_region_karond_kar	climate_frozen	0	9
settlement:wh3_main_combi_region_kauark	climate_frozen	0	0
settlement:wh3_main_combi_region_kemperbad	climate_temperate	0	0
settlement:wh3_main_combi_region_khazid_bordkarag	climate_mountain	0	0
settlement:wh3_main_combi_region_khazid_irkulaz	climate_mountain	0	309
settlement:wh3_main_combi_region_khemri	climate_desert	0	335
settlement:wh3_main_combi_region_khymerica_spire	climate_desert	0	111
settlement:wh3_main_combi_region_kings_glade	climate_magicforest	0	0
settlement:wh3_main_combi_region_kislev	climate_temperate	0	138
settlement:wh3_main_combi_region_konquata	climate_frozen	0	0
settlement:wh3_main_combi_region_kradtommen	climate_mountain	0	230
settlement:wh3_main_combi_region_kraka_drak	climate_mountain	0	249
settlement:wh3_main_combi_region_krugenheim	climate_temperate	0	0
settlement:wh3_main_combi_region_kunlan	climate_temperate	0	0
settlement:wh3_main_combi_region_lahmia	climate_desert	0	88
settlement:wh3_main_combi_region_languille	climate_temperate	0	0
settlement:wh3_main_combi_region_lashiek	climate_desert	0	21
settlement:wh3_main_combi_region_laurelorn_forest	climate_magicforest	0	0
settlement:wh3_main_combi_region_li_temple	climate_mountain	0	33
settlement:wh3_main_combi_region_li_zhu	climate_temperate	0	0
settlement:wh3_main_combi_region_longship_graveyard	climate_frozen	0	0
settlement:wh3_main_combi_region_lost_plateau	climate_mountain	0	0
settlement:wh3_main_combi_region_lothern	climate_island	0	70
settlement:wh3_main_combi_region_luccini	climate_temperate	0	14
settlement:wh3_main_combi_region_lybaras	climate_desert	0	0
settlement:wh3_main_combi_region_lyonesse	climate_temperate	0	0
settlement:wh3_main_combi_region_macu_peaks	climate_jungle	0	0
settlement:wh3_main_combi_region_magritta	climate_temperate	0	324
settlement:wh3_main_combi_region_mahrak	climate_desert	0	0
settlement:wh3_main_combi_region_mangrove_coast	climate_jungle	0	0
settlement:wh3_main_combi_region_marienburg	climate_temperate	0	359
settlement:wh3_main_combi_region_marks_of_the_old_ones	climate_jungle	0	0
settlement:wh3_main_combi_region_martek	climate_mountain	0	127
settlement:wh3_main_combi_region_massif_orcal	climate_mountain	0	0
settlement:wh3_main_combi_region_matorca	climate_temperate	0	0
settlement:wh3_main_combi_region_middenheim	climate_temperate	0	0
settlement:wh3_main_combi_region_middenstag	climate_temperate	0	0
settlement:wh3_main_combi_region_mighdal_vongalbarak	climate_mountain	0	0
settlement:wh3_main_combi_region_mine_of_the_bearded_skulls	climate_mountain	0	284
settlement:wh3_main_combi_region_ming_zhu	climate_temperate	0	310
settlement:wh3_main_combi_region_miragliano	climate_temperate	0	346
settlement:wh3_main_combi_region_mistnar	climate_island	0	359
settlement:wh3_main_combi_region_misty_mountain	climate_mountain	0	265
settlement:wh3_main_combi_region_monolith_of_borkill_the_bloody_handed	climate_chaotic	0	0
settlement:wh3_main_combi_region_monolith_of_bubonicus	climate_chaotic	0	0
settlement:wh3_main_combi_region_monolith_of_festerlung	climate_chaotic	0	0
settlement:wh3_main_combi_region_monolith_of_flesh	climate_chaotic	0	0
settlement:wh3_main_combi_region_montenas	climate_temperate	0	0
settlement:wh3_main_combi_region_montfort	climate_temperate	0	61
settlement:wh3_main_combi_region_monument_of_izzatal	climate_mountain	0	0
settlement:wh3_main_combi_region_monument_of_the_moon	climate_jungle	0	0
settlement:wh3_main_combi_region_mordheim	climate_temperate	0	0
settlement:wh3_main_combi_region_morgheim	climate_wasteland	0	0
settlement:wh3_main_combi_region_mount_arachnos	climate_mountain	0	130
settlement:wh3_main_combi_region_mount_athull	climate_chaotic	0	0
settlement:wh3_main_combi_region_mount_grey_hag	climate_mountain	0	0
settlement:wh3_main_combi_region_mount_gunbad	climate_mountain	0	20
settlement:wh3_main_combi_region_mount_silverspear	climate_mountain	0	0
settlement:wh3_main_combi_region_mount_squighorn	climate_mountain	0	57
settlement:wh3_main_combi_region_mount_thug	climate_mountain	0	0
settlement:wh3_main_combi_region_mousillon	climate_temperate	0	331
settlement:wh3_main_combi_region_myrmidens	climate_temperate	0	0
settlement:wh3_main_combi_region_nagashizzar	climate_wasteland	0	0
settlement:wh3_main_combi_region_nagenhof	climate_temperate	0	0
settlement:wh3_main_combi_region_naggarond	climate_frozen	0	0
settlement:wh3_main_combi_region_naglfari_plain	climate_chaotic	0	0
settlement:wh3_main_combi_region_nagrar	climate_frozen	0	0
settlement:wh3_main_combi_region_nahuontl	climate_jungle	0	343
settlement:wh3_main_combi_region_nan_gau	climate_temperate	0	32
settlement:wh3_main_combi_region_nan_li	climate_temperate	0	29
settlement:wh3_main_combi_region_niedling	climate_temperate	0	0
settlement:wh3_main_combi_region_nongchang	climate_temperate	0	0
settlement:wh3_main_combi_region_norden	climate_temperate	0	359
settlement:wh3_main_combi_region_novchozy	climate_frozen	0	260
settlement:wh3_main_combi_region_nuja	climate_temperate	0	0
settlement:wh3_main_combi_region_nuln	climate_temperate	0	0
settlement:wh3_main_combi_region_numas	climate_desert	0	0
settlement:wh3_main_combi_region_oakenhammer	climate_mountain	0	296
settlement:wh3_main_combi_region_okkams_forever_maze	climate_chaotic	0	186
settlement:wh3_main_combi_region_oreons_camp	climate_magicforest	0	0
settlement:wh3_main_combi_region_oyxl	climate_jungle	0	0
settlement:wh3_main_combi_region_pack_ice_bay	climate_frozen	0	0
settlement:wh3_main_combi_region_pahuax	climate_jungle	0	0
settlement:wh3_main_combi_region_palace_of_princes	climate_chaotic	0	0
settlement:wh3_main_combi_region_parravon	climate_temperate	0	134
settlement:wh3_main_combi_region_petrified_forest	climate_frozen	0	15
settlement:wh3_main_combi_region_pfeildorf	climate_temperate	0	278
settlement:wh3_main_combi_region_phoenix_gate	climate_island	0	173
settlement:wh3_main_combi_region_pigbarter	climate_wasteland	0	0
settlement:wh3_main_combi_region_pillar_of_skulls	climate_frozen	0	0
settlement:wh3_main_combi_region_pillars_of_unseen_constellations	climate_jungle	0	0
settlement:wh3_main_combi_region_plain_of_dogs	climate_mountain	0	89
settlement:wh3_main_combi_region_plain_of_spiders	climate_wasteland	0	0
settlement:wh3_main_combi_region_plain_of_tuskers	climate_desert	0	0
settlement:wh3_main_combi_region_po_mei	climate_temperate	0	68
settlement:wh3_main_combi_region_pools_of_despair	climate_desert	0	0
settlement:wh3_main_combi_region_port_elistor	climate_island	0	0
settlement:wh3_main_combi_region_port_of_secrets	climate_chaotic	0	0
settlement:wh3_main_combi_region_port_reaver	climate_savannah	0	0
settlement:wh3_main_combi_region_pox_marsh	climate_jungle	0	0
settlement:wh3_main_combi_region_praag	climate_frozen	0	163
settlement:wh3_main_combi_region_qiang	climate_temperate	0	70
settlement:wh3_main_combi_region_quatar	climate_desert	0	72
settlement:wh3_main_combi_region_quenelles	climate_temperate	0	151
settlement:wh3_main_combi_region_quetza	climate_jungle	0	0
settlement:wh3_main_combi_region_quittax	climate_jungle	0	0
settlement:wh3_main_combi_region_rackdo_gorge	climate_mountain	0	0
settlement:wh3_main_combi_region_rasetra	climate_desert	0	0
settlement:wh3_main_combi_region_red_fortress	climate_chaotic	0	0
settlement:wh3_main_combi_region_riffraffa	climate_temperate	0	0
settlement:wh3_main_combi_region_rothkar_spire	climate_desert	0	0
settlement:wh3_main_combi_region_ruins_end	climate_wasteland	0	0
settlement:wh3_main_combi_region_sabre_mountain	climate_mountain	0	0
settlement:wh3_main_combi_region_salzenmund	climate_temperate	0	0
settlement:wh3_main_combi_region_sarl_encampment	climate_chaotic	0	0
settlement:wh3_main_combi_region_sartosa	climate_temperate	0	0
settlement:wh3_main_combi_region_scarpels_lair	climate_mountain	0	0
settlement:wh3_main_combi_region_sentinels_of_xeti	climate_jungle	0	0
settlement:wh3_main_combi_region_serpent_coast	climate_jungle	0	337
settlement:wh3_main_combi_region_serpent_jetty	climate_chaotic	0	0
settlement:wh3_main_combi_region_shagrath	climate_frozen	0	0
settlement:wh3_main_combi_region_shang_wu	climate_savannah	0	53
settlement:wh3_main_combi_region_shang_yang	climate_desert	0	338
settlement:wh3_main_combi_region_shard_bastion	climate_chaotic	0	0
settlement:wh3_main_combi_region_shattered_cove	climate_temperate	0	0
settlement:wh3_main_combi_region_shattered_stone_isle	climate_jungle	0	0
settlement:wh3_main_combi_region_shi_long	climate_savannah	0	0
settlement:wh3_main_combi_region_shi_wu	climate_mountain	0	52
settlement:wh3_main_combi_region_shiyamas_rest	climate_temperate	0	161
settlement:wh3_main_combi_region_shrine_of_asuryan	climate_island	0	0
settlement:wh3_main_combi_region_shrine_of_khaine	climate_wasteland	0	0
settlement:wh3_main_combi_region_shrine_of_kurnous	climate_island	0	0
settlement:wh3_main_combi_region_shrine_of_ladrielle	climate_frozen	0	0
settlement:wh3_main_combi_region_shrine_of_loec	climate_island	0	0
settlement:wh3_main_combi_region_shrine_of_sotek	climate_savannah	0	0
settlement:wh3_main_combi_region_shrine_of_the_alchemist	climate_desert	0	140
settlement:wh3_main_combi_region_shroktak_mount	climate_mountain	0	0
settlement:wh3_main_combi_region_silver_pinnacle	climate_mountain	0	66
settlement:wh3_main_combi_region_sjoktraken	climate_frozen	0	0
settlement:wh3_main_combi_region_skavenblight	climate_wasteland	0	346
settlement:wh3_main_combi_region_skeggi	climate_savannah	0	0
settlement:wh3_main_combi_region_skrap_towers	climate_temperate	0	30
settlement:wh3_main_combi_region_slavers_point	climate_frozen	0	322
settlement:wh3_main_combi_region_snake_gate	climate_temperate	0	0
settlement:wh3_main_combi_region_sorcerers_islands	climate_desert	0	0
settlement:wh3_main_combi_region_spektazuma	climate_jungle	0	0
settlement:wh3_main_combi_region_spite_reach	climate_frozen	0	0
settlement:wh3_main_combi_region_spitepeak	climate_mountain	0	0
settlement:wh3_main_combi_region_springs_of_eternal_life	climate_desert	0	0
settlement:wh3_main_combi_region_ssildra_tor	climate_frozen	0	93
settlement:wh3_main_combi_region_statues_of_the_gods	climate_jungle	0	0
settlement:wh3_main_combi_region_steingart	climate_temperate	0	0
settlement:wh3_main_combi_region_stonemine_tower	climate_wasteland	0	0
settlement:wh3_main_combi_region_storag_kor	climate_mountain	0	0
settlement:wh3_main_combi_region_stormhenge	climate_wasteland	0	0
settlement:wh3_main_combi_region_stormvrack_mount	climate_mountain	0	0
settlement:wh3_main_combi_region_subatuun	climate_jungle	0	0
settlement:wh3_main_combi_region_sudenburg	climate_desert	0	0
settlement:wh3_main_combi_region_sulpharets	climate_mountain	0	0
settlement:wh3_main_combi_region_sump_pit	climate_mountain	0	57
settlement:wh3_main_combi_region_sunken_khernarch	climate_wasteland	0	0
settlement:wh3_main_combi_region_swamp_town	climate_savannah	0	0
settlement:wh3_main_combi_region_swartzhafen	climate_temperate	0	0
settlement:wh3_main_combi_region_tai_tzu	climate_mountain	0	0
settlement:wh3_main_combi_region_talabheim	climate_temperate	0	0
settlement:wh3_main_combi_region_temple_avenue_of_gold	climate_jungle	0	0
settlement:wh3_main_combi_region_temple_of_addaioth	climate_frozen	0	0
settlement:wh3_main_combi_region_temple_of_elemental_winds	climate_temperate	0	40
settlement:wh3_main_combi_region_temple_of_heimkel	climate_frozen	0	0
settlement:wh3_main_combi_region_temple_of_kara	climate_jungle	0	0
settlement:wh3_main_combi_region_temple_of_khaine	climate_frozen	0	0
settlement:wh3_main_combi_region_temple_of_skulls	climate_jungle	0	0
settlement:wh3_main_combi_region_temple_of_tlencan	climate_jungle	0	0
settlement:wh3_main_combi_region_teotiqua	climate_jungle	0	0
settlement:wh3_main_combi_region_terracotta_graveyard	climate_temperate	0	167
settlement:wh3_main_combi_region_the_awakening	climate_jungle	0	0
settlement:wh3_main_combi_region_the_black_forests	climate_frozen	0	0
settlement:wh3_main_combi_region_the_black_pillar	climate_frozen	0	0
settlement:wh3_main_combi_region_the_black_pit	climate_mountain	0	0
settlement:wh3_main_combi_region_the_bleeding_spire	climate_chaotic	0	0
settlement:wh3_main_combi_region_the_blighted_grove	climate_chaotic	0	0
settlement:wh3_main_combi_region_the_blood_hall	climate_island	0	0
settlement:wh3_main_combi_region_the_blood_swamps	climate_jungle	0	358
settlement:wh3_main_combi_region_the_bone_gulch	climate_mountain	0	110
settlement:wh3_main_combi_region_the_burning_monolith	climate_chaotic	0	0
settlement:wh3_main_combi_region_the_challenge_stone	climate_chaotic	0	0
settlement:wh3_main_combi_region_the_crystal_spires	climate_chaotic	0	0
settlement:wh3_main_combi_region_the_cursed_jungle	climate_jungle	0	0
settlement:wh3_main_combi_region_the_daemons_stump	climate_wasteland	0	0
settlement:wh3_main_combi_region_the_dust_gate	climate_desert	0	0
settlement:wh3_main_combi_region_the_falls_of_doom	climate_wasteland	0	80
settlement:wh3_main_combi_region_the_fetid_catacombs	climate_chaotic	0	0
settlement:wh3_main_combi_region_the_folly_of_malofex	climate_chaotic	0	0
settlement:wh3_main_combi_region_the_forbidden_citadel	climate_chaotic	0	0
settlement:wh3_main_combi_region_the_forest_of_decay	climate_chaotic	0	0
settlement:wh3_main_combi_region_the_fortress_of_vorag	climate_wasteland	0	0
settlement:wh3_main_combi_region_the_frozen_city	climate_frozen	0	0
settlement:wh3_main_combi_region_the_galleons_graveyard	climate_ocean	0	0
settlement:wh3_main_combi_region_the_gallows_tree	climate_chaotic	0	0
settlement:wh3_main_combi_region_the_gates_of_zharr	climate_wasteland	0	0
settlement:wh3_main_combi_region_the_godless_crater	climate_chaotic	0	0
settlement:wh3_main_combi_region_the_golden_colossus	climate_desert	0	0
settlement:wh3_main_combi_region_the_golden_tower	climate_jungle	0	42
settlement:wh3_main_combi_region_the_great_arena	climate_frozen	0	192
settlement:wh3_main_combi_region_the_haunted_forest	climate_magicforest	0	0
settlement:wh3_main_combi_region_the_high_place	climate_mountain	0	268
settlement:wh3_main_combi_region_the_high_sentinel	climate_savannah	0	0
settlement:wh3_main_combi_region_the_howling_citadel	climate_chaotic	0	0
settlement:wh3_main_combi_region_the_lost_palace	climate_chaotic	0	0
settlement:wh3_main_combi_region_the_maw_gate	climate_mountain	0	0
settlement:wh3_main_combi_region_the_monolith_of_katam	climate_chaotic	0	0
settlement:wh3_main_combi_region_the_monoliths	climate_frozen	0	222
settlement:wh3_main_combi_region_the_moon_shard	climate_frozen	0	0
settlement:wh3_main_combi_region_the_moot	climate_temperate	0	0
settlement:wh3_main_combi_region_the_never_ending_chasm	climate_chaotic	0	0
settlement:wh3_main_combi_region_the_oak_of_ages	climate_magicforest	0	0
settlement:wh3_main_combi_region_the_palace_of_ruin	climate_chaotic	0	0
settlement:wh3_main_combi_region_the_pillars_of_grungni	climate_mountain	0	230
settlement:wh3_main_combi_region_the_sacred_pools	climate_magicforest	0	0
settlement:wh3_main_combi_region_the_sentinel_of_time	climate_savannah	0	0
settlement:wh3_main_combi_region_the_sentinels	climate_wasteland	0	0
settlement:wh3_main_combi_region_the_silvered_tower_of_sorcerers	climate_chaotic	0	0
settlement:wh3_main_combi_region_the_sinhall_monolith	climate_chaotic	0	348
settlement:wh3_main_combi_region_the_skull_carvers_abode	climate_chaotic	0	62
settlement:wh3_main_combi_region_the_southern_sentinels	climate_savannah	0	0
settlement:wh3_main_combi_region_the_star_tower	climate_jungle	0	0
settlement:wh3_main_combi_region_the_tower_of_flies	climate_chaotic	0	0
settlement:wh3_main_combi_region_the_tower_of_khrakk	climate_frozen	0	0
settlement:wh3_main_combi_region_the_tower_of_torment	climate_frozen	0	0
settlement:wh3_main_combi_region_the_twisted_glade	climate_frozen	0	330
settlement:wh3_main_combi_region_the_twisted_towers	climate_chaotic	0	0
settlement:wh3_main_combi_region_the_volary	climate_chaotic	0	0
settlement:wh3_main_combi_region_the_witchwood	climate_magicforest	0	0
settlement:wh3_main_combi_region_the_writhing_fortress	climate_chaotic	0	0
settlement:wh3_main_combi_region_thrice_cursed_peak	climate_mountain	0	102
settlement:wh3_main_combi_region_titans_notch	climate_mountain	0	40
settlement:wh3_main_combi_region_tlanxla	climate_jungle	0	0
settlement:wh3_main_combi_region_tlaqua	climate_jungle	0	185
settlement:wh3_main_combi_region_tlax	climate_jungle	0	0
settlement:wh3_main_combi_region_tlaxtlan	climate_jungle	0	0
settlement:wh3_main_combi_region_tobaro	climate_temperate	0	53
settlement:wh3_main_combi_region_tor_achare	climate_island	0	0
settlement:wh3_main_combi_region_tor_anlec	climate_wasteland	0	344
settlement:wh3_main_combi_region_tor_anroc	climate_island	0	52
settlement:wh3_main_combi_region_tor_dranil	climate_wasteland	0	22
settlement:wh3_main_combi_region_tor_elasor	climate_island	0	0
settlement:wh3_main_combi_region_tor_elyr	climate_island	0	0
settlement:wh3_main_combi_region_tor_finu	climate_island	0	107
settlement:wh3_main_combi_region_tor_koruali	climate_island	0	0
settlement:wh3_main_combi_region_tor_saroir	climate_island	0	0
settlement:wh3_main_combi_region_tor_sethai	climate_island	0	310
settlement:wh3_main_combi_region_tor_surpindar	climate_savannah	0	0
settlement:wh3_main_combi_region_tor_yvresse	climate_island	0	0
settlement:wh3_main_combi_region_tower_of_ashung	climate_jungle	0	0
settlement:wh3_main_combi_region_tower_of_gorgoth	climate_mountain	0	184
settlement:wh3_main_combi_region_tower_of_lysean	climate_island	0	0
settlement:wh3_main_combi_region_tower_of_the_stars	climate_island	0	0
settlement:wh3_main_combi_region_tower_of_the_sun	climate_island	0	0
settlement:wh3_main_combi_region_tralinia	climate_island	0	306
settlement:wh3_main_combi_region_tribeslaughter	climate_frozen	0	0
settlement:wh3_main_combi_region_troll_fjord	climate_frozen	0	0
settlement:wh3_main_combi_region_turtle_gate	climate_temperate	0	0
settlement:wh3_main_combi_region_tyrant_peak	climate_mountain	0	0
settlement:wh3_main_combi_region_ubersreik	climate_temperate	0	0
settlement:wh3_main_combi_region_unicorn_gate	climate_island	0	332
settlement:wh3_main_combi_region_uzkulak	climate_wasteland	0	39
settlement:wh3_main_combi_region_valayas_sorrow	climate_wasteland	0	0
settlement:wh3_main_combi_region_vale_of_titans	climate_mountain	0	0
settlement:wh3_main_combi_region_valley_of_horns	climate_mountain	0	61
settlement:wh3_main_combi_region_varenka_hills	climate_wasteland	0	90
settlement:wh3_main_combi_region_varg_camp	climate_chaotic	0	0
settlement:wh3_main_combi_region_vauls_anvil_loren	climate_magicforest	0	0
settlement:wh3_main_combi_region_vauls_anvil_naggaroth	climate_frozen	0	0
settlement:wh3_main_combi_region_vauls_anvil_ulthuan	climate_island	0	209
settlement:wh3_main_combi_region_venom_glade	climate_frozen	0	0
settlement:wh3_main_combi_region_verdanos	climate_temperate	0	0
settlement:wh3_main_combi_region_village_of_the_moon	climate_temperate	0	0
settlement:wh3_main_combi_region_village_of_the_tigermen	climate_temperate	0	353
settlement:wh3_main_combi_region_vitevo	climate_temperate	0	247
settlement:wh3_main_combi_region_volcanos_heart	climate_chaotic	0	0
settlement:wh3_main_combi_region_volksgrad	climate_frozen	0	170
settlement:wh3_main_combi_region_volulltrax	climate_chaotic	0	352
settlement:wh3_main_combi_region_vulture_mountain	climate_mountain	0	221
settlement:wh3_main_combi_region_waili_village	climate_jungle	0	122
settlement:wh3_main_combi_region_waldenhof	climate_temperate	0	0
settlement:wh3_main_combi_region_waterfall_palace	climate_magicforest	0	0
settlement:wh3_main_combi_region_wei_jin	climate_temperate	0	55
settlement:wh3_main_combi_region_weismund	climate_temperate	0	0
settlement:wh3_main_combi_region_wellsprings_of_eternity	climate_jungle	0	0
settlement:wh3_main_combi_region_weng_chang	climate_mountain	0	247
settlement:wh3_main_combi_region_white_tower_of_hoeth	climate_island	0	182
settlement:wh3_main_combi_region_whitefire_tor	climate_island	0	0
settlement:wh3_main_combi_region_whitepeak	climate_island	0	0
settlement:wh3_main_combi_region_winter_pyre	climate_frozen	0	0
settlement:wh3_main_combi_region_wissenburg	climate_temperate	0	0
settlement:wh3_main_combi_region_wizard_caliphs_palace	climate_desert	0	8
settlement:wh3_main_combi_region_wolfenburg	climate_temperate	0	0
settlement:wh3_main_combi_region_worlds_edge_archway	climate_mountain	0	226
settlement:wh3_main_combi_region_wreckers_point	climate_temperate	0	0
settlement:wh3_main_combi_region_wurtbad	climate_temperate	0	0
settlement:wh3_main_combi_region_xahutec	climate_jungle	0	0
settlement:wh3_main_combi_region_xen_wu	climate_temperate	0	0
settlement:wh3_main_combi_region_xhotl	climate_jungle	0	0
settlement:wh3_main_combi_region_xing_po	climate_mountain	0	0
settlement:wh3_main_combi_region_xlanhuapec	climate_jungle	0	0
settlement:wh3_main_combi_region_xlanzec	climate_savannah	0	0
settlement:wh3_main_combi_region_yetchitch	climate_frozen	0	67
settlement:wh3_main_combi_region_yhetee_peak	climate_mountain	0	28
settlement:wh3_main_combi_region_yuatek	climate_jungle	0	0
settlement:wh3_main_combi_region_zanbaijin	climate_chaotic	0	0
settlement:wh3_main_combi_region_zandri	climate_desert	0	0
settlement:wh3_main_combi_region_zarakzil	climate_mountain	0	95
settlement:wh3_main_combi_region_zavastra	climate_temperate	0	219
settlement:wh3_main_combi_region_zhanshi	climate_temperate	0	0
settlement:wh3_main_combi_region_zharr_naggrund	climate_wasteland	0	47
settlement:wh3_main_combi_region_zhizhu	climate_temperate	0	0
settlement:wh3_main_combi_region_zhufbar	climate_mountain	0	27
settlement:wh3_main_combi_region_ziggurat_of_dawn	climate_jungle	0	0
settlement:wh3_main_combi_region_zlatlan	climate_jungle	0	43
settlement:wh3_main_combi_region_zoishenk	climate_frozen	0	182
settlement:wh3_main_combi_region_zvorak	climate_temperate	0	38
settlement:wh3_prologue_broken_lands_tong_hall	climate_temperate	0	0
settlement:wh3_prologue_canyons_of_gore_gore_town	climate_temperate	0	174
settlement:wh3_prologue_crater_of_lies_the_howling_citadel	climate_temperate	0	0
settlement:wh3_prologue_crimson_vale_hall_of_the_keepers	climate_temperate	0	0
settlement:wh3_prologue_fleshlands_blood_haven	climate_temperate	0	0
settlement:wh3_prologue_frozen_plains_dervingard	climate_temperate	0	101
settlement:wh3_prologue_icecaid_pass_claw_reach	climate_temperate	0	0
settlement:wh3_prologue_mirror_marches_the_loci_palace	climate_temperate	0	89
settlement:wh3_prologue_mountain_pass_kislev_encampment	climate_temperate	0	0
settlement:wh3_prologue_plains_of_brass_the_tah_camp	climate_temperate	0	0
settlement:wh3_prologue_river_of_the_flux_the_fording_place	climate_temperate	0	274
settlement:wh3_prologue_settlement_ice_canyon_beacon_fort	climate_temperate	0	0
settlement:wh3_prologue_the_falls_of_circatrex_the_rookery	climate_temperate	0	217
settlement:wh3_prologue_the_maze_keep_mansion_of_eyes	climate_temperate	0	196
settlement:wh3_prologue_the_scarlet_steppes_the_blood_moot	climate_temperate	0	0
settlement:wh3_prologue_the_void_lands_mansion_of_eyes	climate_temperate	0	0
settlement:wh3_prologue_the_void_steppes_the_monolith_of_the_void	climate_temperate	0	0
settlementwh3_main_combi_region_dawns_light	climate_savannah	0	0
settlementwh3_main_combi_region_deaths_head_monoliths	climate_desert	0	0
settlementwh3_main_combi_region_soteks_trail	climate_jungle	0	0
settlementwh3_main_combi_region_sun_tree_glades	climate_jungle	0	0
