battle_set_piece	bmd	environment
#battle_set_piece_campaign_battle_scenes_tables;0;db/battle_set_piece_campaign_battle_scenes_tables/data__		
wh2_dlc11_qb_cst_final_battle	prefabs/campaign/underwater_battle.bmd	terrain/campaigns/warhammer_map_1_1_wood_elves/lighting/prebattle_underwater.environment
wh2_dlc11_qb_cst_final_battle_aranessa	prefabs/campaign/underwater_battle.bmd	terrain/campaigns/warhammer_map_1_1_wood_elves/lighting/prebattle_underwater.environment
wh2_dlc11_qb_cst_final_battle_cylostra	prefabs/campaign/underwater_battle.bmd	terrain/campaigns/warhammer_map_1_1_wood_elves/lighting/prebattle_underwater.environment
wh2_dlc11_qb_cst_final_battle_noctilus	prefabs/campaign/underwater_battle.bmd	terrain/campaigns/warhammer_map_1_1_wood_elves/lighting/prebattle_underwater.environment
wh2_dlc12_great_vortex_kroqgar_lord_kroak_stage_3	prefabs/campaign/kroak_battle.bmd	terrain/campaigns/warhammer_map_1_1_wood_elves/lighting/lizardmen.environment
wh2_dlc12_great_vortex_mazdamundi_lord_kroak_stage_3	prefabs/campaign/kroak_battle.bmd	terrain/campaigns/warhammer_map_1_1_wood_elves/lighting/lizardmen.environment
wh2_dlc12_great_vortex_tehenhauin_lord_kroak_stage_3	prefabs/campaign/kroak_battle.bmd	terrain/campaigns/warhammer_map_1_1_wood_elves/lighting/lizardmen.environment
wh2_dlc12_great_vortex_tiktaqto_lord_kroak_stage_3	prefabs/campaign/kroak_battle.bmd	terrain/campaigns/warhammer_map_1_1_wood_elves/lighting/lizardmen.environment
wh2_dlc12_vor_gorrok_lord_kroak_stage_3	prefabs/campaign/kroak_battle.bmd	terrain/campaigns/warhammer_map_1_1_wood_elves/lighting/lizardmen.environment
wh2_dlc12_vor_nakai_lord_kroak_stage_3	prefabs/campaign/kroak_battle.bmd	terrain/campaigns/warhammer_map_1_1_wood_elves/lighting/lizardmen.environment
wh2_dlc12_vor_oxyotl_lord_kroak_stage_3	prefabs/campaign/kroak_battle.bmd	terrain/campaigns/warhammer_map_1_1_wood_elves/lighting/lizardmen.environment
wh3_main_survival_forge_of_souls_wh3_main_cth_miao_ying	prefabs/campaign/forge_of_souls_battle.bmd	terrain/campaigns/wh3_main_chaos_map_1/lighting/khorne.environment
wh3_main_survival_forge_of_souls_wh3_main_cth_zhao_ming	prefabs/campaign/forge_of_souls_battle.bmd	terrain/campaigns/wh3_main_chaos_map_1/lighting/khorne.environment
wh3_main_survival_forge_of_souls_wh3_main_dae_daemon_prince	prefabs/campaign/forge_of_souls_battle.bmd	terrain/campaigns/wh3_main_chaos_map_1/lighting/khorne.environment
wh3_main_survival_forge_of_souls_wh3_main_kho_skarbrand	prefabs/campaign/forge_of_souls_battle.bmd	terrain/campaigns/wh3_main_chaos_map_1/lighting/khorne.environment
wh3_main_survival_forge_of_souls_wh3_main_ksl_boris	prefabs/campaign/forge_of_souls_battle.bmd	terrain/campaigns/wh3_main_chaos_map_1/lighting/khorne.environment
wh3_main_survival_forge_of_souls_wh3_main_ksl_katarin	prefabs/campaign/forge_of_souls_battle.bmd	terrain/campaigns/wh3_main_chaos_map_1/lighting/khorne.environment
wh3_main_survival_forge_of_souls_wh3_main_ksl_kostaltyn	prefabs/campaign/forge_of_souls_battle.bmd	terrain/campaigns/wh3_main_chaos_map_1/lighting/khorne.environment
wh3_main_survival_forge_of_souls_wh3_main_nur_kugath	prefabs/campaign/forge_of_souls_battle.bmd	terrain/campaigns/wh3_main_chaos_map_1/lighting/khorne.environment
wh3_main_survival_forge_of_souls_wh3_main_ogr_greasus_goldtooth	prefabs/campaign/forge_of_souls_battle.bmd	terrain/campaigns/wh3_main_chaos_map_1/lighting/khorne.environment
wh3_main_survival_forge_of_souls_wh3_main_ogr_skrag_the_slaughterer	prefabs/campaign/forge_of_souls_battle.bmd	terrain/campaigns/wh3_main_chaos_map_1/lighting/khorne.environment
wh3_main_survival_forge_of_souls_wh3_main_sla_nkari	prefabs/campaign/forge_of_souls_battle.bmd	terrain/campaigns/wh3_main_chaos_map_1/lighting/khorne.environment
wh3_main_survival_forge_of_souls_wh3_main_tze_kairos	prefabs/campaign/forge_of_souls_battle.bmd	terrain/campaigns/wh3_main_chaos_map_1/lighting/khorne.environment
wh3_main_survival_khorne_wh3_main_cth_miao_ying	prefabs/campaign/kho_final_battle.bmd	terrain/campaigns/wh3_main_chaos_map_1/lighting/khorne.environment
wh3_main_survival_khorne_wh3_main_cth_miao_ying_easy	prefabs/campaign/kho_final_battle.bmd	terrain/campaigns/wh3_main_chaos_map_1/lighting/khorne.environment
wh3_main_survival_khorne_wh3_main_cth_miao_ying_hard	prefabs/campaign/kho_final_battle.bmd	terrain/campaigns/wh3_main_chaos_map_1/lighting/khorne.environment
wh3_main_survival_khorne_wh3_main_cth_zhao_ming	prefabs/campaign/kho_final_battle.bmd	terrain/campaigns/wh3_main_chaos_map_1/lighting/khorne.environment
wh3_main_survival_khorne_wh3_main_cth_zhao_ming_easy	prefabs/campaign/kho_final_battle.bmd	terrain/campaigns/wh3_main_chaos_map_1/lighting/khorne.environment
wh3_main_survival_khorne_wh3_main_cth_zhao_ming_hard	prefabs/campaign/kho_final_battle.bmd	terrain/campaigns/wh3_main_chaos_map_1/lighting/khorne.environment
wh3_main_survival_khorne_wh3_main_dae_daemon_prince	prefabs/campaign/kho_final_battle.bmd	terrain/campaigns/wh3_main_chaos_map_1/lighting/khorne.environment
wh3_main_survival_khorne_wh3_main_dae_daemon_prince_easy	prefabs/campaign/kho_final_battle.bmd	terrain/campaigns/wh3_main_chaos_map_1/lighting/khorne.environment
wh3_main_survival_khorne_wh3_main_dae_daemon_prince_hard	prefabs/campaign/kho_final_battle.bmd	terrain/campaigns/wh3_main_chaos_map_1/lighting/khorne.environment
wh3_main_survival_khorne_wh3_main_kho_skarbrand	prefabs/campaign/kho_final_battle.bmd	terrain/campaigns/wh3_main_chaos_map_1/lighting/khorne.environment
wh3_main_survival_khorne_wh3_main_kho_skarbrand_easy	prefabs/campaign/kho_final_battle.bmd	terrain/campaigns/wh3_main_chaos_map_1/lighting/khorne.environment
wh3_main_survival_khorne_wh3_main_kho_skarbrand_hard	prefabs/campaign/kho_final_battle.bmd	terrain/campaigns/wh3_main_chaos_map_1/lighting/khorne.environment
wh3_main_survival_khorne_wh3_main_ksl_boris	prefabs/campaign/kho_final_battle.bmd	terrain/campaigns/wh3_main_chaos_map_1/lighting/khorne.environment
wh3_main_survival_khorne_wh3_main_ksl_boris_easy	prefabs/campaign/kho_final_battle.bmd	terrain/campaigns/wh3_main_chaos_map_1/lighting/khorne.environment
wh3_main_survival_khorne_wh3_main_ksl_boris_hard	prefabs/campaign/kho_final_battle.bmd	terrain/campaigns/wh3_main_chaos_map_1/lighting/khorne.environment
wh3_main_survival_khorne_wh3_main_ksl_katarin	prefabs/campaign/kho_final_battle.bmd	terrain/campaigns/wh3_main_chaos_map_1/lighting/khorne.environment
wh3_main_survival_khorne_wh3_main_ksl_katarin_easy	prefabs/campaign/kho_final_battle.bmd	terrain/campaigns/wh3_main_chaos_map_1/lighting/khorne.environment
wh3_main_survival_khorne_wh3_main_ksl_katarin_hard	prefabs/campaign/kho_final_battle.bmd	terrain/campaigns/wh3_main_chaos_map_1/lighting/khorne.environment
wh3_main_survival_khorne_wh3_main_ksl_kostaltyn	prefabs/campaign/kho_final_battle.bmd	terrain/campaigns/wh3_main_chaos_map_1/lighting/khorne.environment
wh3_main_survival_khorne_wh3_main_ksl_kostaltyn_easy	prefabs/campaign/kho_final_battle.bmd	terrain/campaigns/wh3_main_chaos_map_1/lighting/khorne.environment
wh3_main_survival_khorne_wh3_main_ksl_kostaltyn_hard	prefabs/campaign/kho_final_battle.bmd	terrain/campaigns/wh3_main_chaos_map_1/lighting/khorne.environment
wh3_main_survival_khorne_wh3_main_nur_kugath	prefabs/campaign/kho_final_battle.bmd	terrain/campaigns/wh3_main_chaos_map_1/lighting/khorne.environment
wh3_main_survival_khorne_wh3_main_nur_kugath_easy	prefabs/campaign/kho_final_battle.bmd	terrain/campaigns/wh3_main_chaos_map_1/lighting/khorne.environment
wh3_main_survival_khorne_wh3_main_nur_kugath_hard	prefabs/campaign/kho_final_battle.bmd	terrain/campaigns/wh3_main_chaos_map_1/lighting/khorne.environment
wh3_main_survival_khorne_wh3_main_ogr_greasus_goldtooth	prefabs/campaign/kho_final_battle.bmd	terrain/campaigns/wh3_main_chaos_map_1/lighting/khorne.environment
wh3_main_survival_khorne_wh3_main_ogr_greasus_goldtooth_easy	prefabs/campaign/kho_final_battle.bmd	terrain/campaigns/wh3_main_chaos_map_1/lighting/khorne.environment
wh3_main_survival_khorne_wh3_main_ogr_greasus_goldtooth_hard	prefabs/campaign/kho_final_battle.bmd	terrain/campaigns/wh3_main_chaos_map_1/lighting/khorne.environment
wh3_main_survival_khorne_wh3_main_ogr_skrag_the_slaughterer	prefabs/campaign/kho_final_battle.bmd	terrain/campaigns/wh3_main_chaos_map_1/lighting/khorne.environment
wh3_main_survival_khorne_wh3_main_ogr_skrag_the_slaughterer_easy	prefabs/campaign/kho_final_battle.bmd	terrain/campaigns/wh3_main_chaos_map_1/lighting/khorne.environment
wh3_main_survival_khorne_wh3_main_ogr_skrag_the_slaughterer_hard	prefabs/campaign/kho_final_battle.bmd	terrain/campaigns/wh3_main_chaos_map_1/lighting/khorne.environment
wh3_main_survival_khorne_wh3_main_sla_nkari	prefabs/campaign/kho_final_battle.bmd	terrain/campaigns/wh3_main_chaos_map_1/lighting/khorne.environment
wh3_main_survival_khorne_wh3_main_sla_nkari_easy	prefabs/campaign/kho_final_battle.bmd	terrain/campaigns/wh3_main_chaos_map_1/lighting/khorne.environment
wh3_main_survival_khorne_wh3_main_sla_nkari_hard	prefabs/campaign/kho_final_battle.bmd	terrain/campaigns/wh3_main_chaos_map_1/lighting/khorne.environment
wh3_main_survival_khorne_wh3_main_tze_kairos	prefabs/campaign/kho_final_battle.bmd	terrain/campaigns/wh3_main_chaos_map_1/lighting/khorne.environment
wh3_main_survival_khorne_wh3_main_tze_kairos_easy	prefabs/campaign/kho_final_battle.bmd	terrain/campaigns/wh3_main_chaos_map_1/lighting/khorne.environment
wh3_main_survival_khorne_wh3_main_tze_kairos_hard	prefabs/campaign/kho_final_battle.bmd	terrain/campaigns/wh3_main_chaos_map_1/lighting/khorne.environment
wh3_main_survival_nurgle_wh3_main_cth_miao_ying	prefabs/campaign/nur_final_battle.bmd	terrain/campaigns/wh3_main_chaos_map_1/lighting/nurgle.environment
wh3_main_survival_nurgle_wh3_main_cth_miao_ying_easy	prefabs/campaign/nur_final_battle.bmd	terrain/campaigns/wh3_main_chaos_map_1/lighting/nurgle.environment
wh3_main_survival_nurgle_wh3_main_cth_miao_ying_hard	prefabs/campaign/nur_final_battle.bmd	terrain/campaigns/wh3_main_chaos_map_1/lighting/nurgle.environment
wh3_main_survival_nurgle_wh3_main_cth_zhao_ming	prefabs/campaign/nur_final_battle.bmd	terrain/campaigns/wh3_main_chaos_map_1/lighting/nurgle.environment
wh3_main_survival_nurgle_wh3_main_cth_zhao_ming_easy	prefabs/campaign/nur_final_battle.bmd	terrain/campaigns/wh3_main_chaos_map_1/lighting/nurgle.environment
wh3_main_survival_nurgle_wh3_main_cth_zhao_ming_hard	prefabs/campaign/nur_final_battle.bmd	terrain/campaigns/wh3_main_chaos_map_1/lighting/nurgle.environment
wh3_main_survival_nurgle_wh3_main_dae_daemon_prince	prefabs/campaign/nur_final_battle.bmd	terrain/campaigns/wh3_main_chaos_map_1/lighting/nurgle.environment
wh3_main_survival_nurgle_wh3_main_dae_daemon_prince_easy	prefabs/campaign/nur_final_battle.bmd	terrain/campaigns/wh3_main_chaos_map_1/lighting/nurgle.environment
wh3_main_survival_nurgle_wh3_main_dae_daemon_prince_hard	prefabs/campaign/nur_final_battle.bmd	terrain/campaigns/wh3_main_chaos_map_1/lighting/nurgle.environment
wh3_main_survival_nurgle_wh3_main_kho_skarbrand	prefabs/campaign/nur_final_battle.bmd	terrain/campaigns/wh3_main_chaos_map_1/lighting/nurgle.environment
wh3_main_survival_nurgle_wh3_main_kho_skarbrand_easy	prefabs/campaign/nur_final_battle.bmd	terrain/campaigns/wh3_main_chaos_map_1/lighting/nurgle.environment
wh3_main_survival_nurgle_wh3_main_kho_skarbrand_hard	prefabs/campaign/nur_final_battle.bmd	terrain/campaigns/wh3_main_chaos_map_1/lighting/nurgle.environment
wh3_main_survival_nurgle_wh3_main_ksl_boris	prefabs/campaign/nur_final_battle.bmd	terrain/campaigns/wh3_main_chaos_map_1/lighting/nurgle.environment
wh3_main_survival_nurgle_wh3_main_ksl_boris_easy	prefabs/campaign/nur_final_battle.bmd	terrain/campaigns/wh3_main_chaos_map_1/lighting/nurgle.environment
wh3_main_survival_nurgle_wh3_main_ksl_boris_hard	prefabs/campaign/nur_final_battle.bmd	terrain/campaigns/wh3_main_chaos_map_1/lighting/nurgle.environment
wh3_main_survival_nurgle_wh3_main_ksl_katarin	prefabs/campaign/nur_final_battle.bmd	terrain/campaigns/wh3_main_chaos_map_1/lighting/nurgle.environment
wh3_main_survival_nurgle_wh3_main_ksl_katarin_easy	prefabs/campaign/nur_final_battle.bmd	terrain/campaigns/wh3_main_chaos_map_1/lighting/nurgle.environment
wh3_main_survival_nurgle_wh3_main_ksl_katarin_hard	prefabs/campaign/nur_final_battle.bmd	terrain/campaigns/wh3_main_chaos_map_1/lighting/nurgle.environment
wh3_main_survival_nurgle_wh3_main_ksl_kostaltyn	prefabs/campaign/nur_final_battle.bmd	terrain/campaigns/wh3_main_chaos_map_1/lighting/nurgle.environment
wh3_main_survival_nurgle_wh3_main_ksl_kostaltyn_easy	prefabs/campaign/nur_final_battle.bmd	terrain/campaigns/wh3_main_chaos_map_1/lighting/nurgle.environment
wh3_main_survival_nurgle_wh3_main_ksl_kostaltyn_hard	prefabs/campaign/nur_final_battle.bmd	terrain/campaigns/wh3_main_chaos_map_1/lighting/nurgle.environment
wh3_main_survival_nurgle_wh3_main_nur_kugath	prefabs/campaign/nur_final_battle.bmd	terrain/campaigns/wh3_main_chaos_map_1/lighting/nurgle.environment
wh3_main_survival_nurgle_wh3_main_nur_kugath_easy	prefabs/campaign/nur_final_battle.bmd	terrain/campaigns/wh3_main_chaos_map_1/lighting/nurgle.environment
wh3_main_survival_nurgle_wh3_main_nur_kugath_hard	prefabs/campaign/nur_final_battle.bmd	terrain/campaigns/wh3_main_chaos_map_1/lighting/nurgle.environment
wh3_main_survival_nurgle_wh3_main_ogr_greasus_goldtooth	prefabs/campaign/nur_final_battle.bmd	terrain/campaigns/wh3_main_chaos_map_1/lighting/nurgle.environment
wh3_main_survival_nurgle_wh3_main_ogr_greasus_goldtooth_easy	prefabs/campaign/nur_final_battle.bmd	terrain/campaigns/wh3_main_chaos_map_1/lighting/nurgle.environment
wh3_main_survival_nurgle_wh3_main_ogr_greasus_goldtooth_hard	prefabs/campaign/nur_final_battle.bmd	terrain/campaigns/wh3_main_chaos_map_1/lighting/nurgle.environment
wh3_main_survival_nurgle_wh3_main_ogr_skrag_the_slaughterer	prefabs/campaign/nur_final_battle.bmd	terrain/campaigns/wh3_main_chaos_map_1/lighting/nurgle.environment
wh3_main_survival_nurgle_wh3_main_ogr_skrag_the_slaughterer_easy	prefabs/campaign/nur_final_battle.bmd	terrain/campaigns/wh3_main_chaos_map_1/lighting/nurgle.environment
wh3_main_survival_nurgle_wh3_main_ogr_skrag_the_slaughterer_hard	prefabs/campaign/nur_final_battle.bmd	terrain/campaigns/wh3_main_chaos_map_1/lighting/nurgle.environment
wh3_main_survival_nurgle_wh3_main_sla_nkari	prefabs/campaign/nur_final_battle.bmd	terrain/campaigns/wh3_main_chaos_map_1/lighting/nurgle.environment
wh3_main_survival_nurgle_wh3_main_sla_nkari_easy	prefabs/campaign/nur_final_battle.bmd	terrain/campaigns/wh3_main_chaos_map_1/lighting/nurgle.environment
wh3_main_survival_nurgle_wh3_main_sla_nkari_hard	prefabs/campaign/nur_final_battle.bmd	terrain/campaigns/wh3_main_chaos_map_1/lighting/nurgle.environment
wh3_main_survival_nurgle_wh3_main_tze_kairos	prefabs/campaign/nur_final_battle.bmd	terrain/campaigns/wh3_main_chaos_map_1/lighting/nurgle.environment
wh3_main_survival_nurgle_wh3_main_tze_kairos_easy	prefabs/campaign/nur_final_battle.bmd	terrain/campaigns/wh3_main_chaos_map_1/lighting/nurgle.environment
wh3_main_survival_nurgle_wh3_main_tze_kairos_hard	prefabs/campaign/nur_final_battle.bmd	terrain/campaigns/wh3_main_chaos_map_1/lighting/nurgle.environment
wh3_main_survival_slaanesh_wh3_main_cth_miao_ying	prefabs/campaign/slaanesh_final_battle.bmd	terrain/campaigns/wh3_main_chaos_map_1/lighting/slaanesh.environment
wh3_main_survival_slaanesh_wh3_main_cth_miao_ying_easy	prefabs/campaign/slaanesh_final_battle.bmd	terrain/campaigns/wh3_main_chaos_map_1/lighting/slaanesh.environment
wh3_main_survival_slaanesh_wh3_main_cth_miao_ying_hard	prefabs/campaign/slaanesh_final_battle.bmd	terrain/campaigns/wh3_main_chaos_map_1/lighting/slaanesh.environment
wh3_main_survival_slaanesh_wh3_main_cth_zhao_ming	prefabs/campaign/slaanesh_final_battle.bmd	terrain/campaigns/wh3_main_chaos_map_1/lighting/slaanesh.environment
wh3_main_survival_slaanesh_wh3_main_cth_zhao_ming_easy	prefabs/campaign/slaanesh_final_battle.bmd	terrain/campaigns/wh3_main_chaos_map_1/lighting/slaanesh.environment
wh3_main_survival_slaanesh_wh3_main_cth_zhao_ming_hard	prefabs/campaign/slaanesh_final_battle.bmd	terrain/campaigns/wh3_main_chaos_map_1/lighting/slaanesh.environment
wh3_main_survival_slaanesh_wh3_main_dae_daemon_prince	prefabs/campaign/slaanesh_final_battle.bmd	terrain/campaigns/wh3_main_chaos_map_1/lighting/slaanesh.environment
wh3_main_survival_slaanesh_wh3_main_dae_daemon_prince_easy	prefabs/campaign/slaanesh_final_battle.bmd	terrain/campaigns/wh3_main_chaos_map_1/lighting/slaanesh.environment
wh3_main_survival_slaanesh_wh3_main_dae_daemon_prince_hard	prefabs/campaign/slaanesh_final_battle.bmd	terrain/campaigns/wh3_main_chaos_map_1/lighting/slaanesh.environment
wh3_main_survival_slaanesh_wh3_main_kho_skarbrand	prefabs/campaign/slaanesh_final_battle.bmd	terrain/campaigns/wh3_main_chaos_map_1/lighting/slaanesh.environment
wh3_main_survival_slaanesh_wh3_main_kho_skarbrand_easy	prefabs/campaign/slaanesh_final_battle.bmd	terrain/campaigns/wh3_main_chaos_map_1/lighting/slaanesh.environment
wh3_main_survival_slaanesh_wh3_main_kho_skarbrand_hard	prefabs/campaign/slaanesh_final_battle.bmd	terrain/campaigns/wh3_main_chaos_map_1/lighting/slaanesh.environment
wh3_main_survival_slaanesh_wh3_main_ksl_boris	prefabs/campaign/slaanesh_final_battle.bmd	terrain/campaigns/wh3_main_chaos_map_1/lighting/slaanesh.environment
wh3_main_survival_slaanesh_wh3_main_ksl_boris_easy	prefabs/campaign/slaanesh_final_battle.bmd	terrain/campaigns/wh3_main_chaos_map_1/lighting/slaanesh.environment
wh3_main_survival_slaanesh_wh3_main_ksl_boris_hard	prefabs/campaign/slaanesh_final_battle.bmd	terrain/campaigns/wh3_main_chaos_map_1/lighting/slaanesh.environment
wh3_main_survival_slaanesh_wh3_main_ksl_katarin	prefabs/campaign/slaanesh_final_battle.bmd	terrain/campaigns/wh3_main_chaos_map_1/lighting/slaanesh.environment
wh3_main_survival_slaanesh_wh3_main_ksl_katarin_easy	prefabs/campaign/slaanesh_final_battle.bmd	terrain/campaigns/wh3_main_chaos_map_1/lighting/slaanesh.environment
wh3_main_survival_slaanesh_wh3_main_ksl_katarin_hard	prefabs/campaign/slaanesh_final_battle.bmd	terrain/campaigns/wh3_main_chaos_map_1/lighting/slaanesh.environment
wh3_main_survival_slaanesh_wh3_main_ksl_kostaltyn	prefabs/campaign/slaanesh_final_battle.bmd	terrain/campaigns/wh3_main_chaos_map_1/lighting/slaanesh.environment
wh3_main_survival_slaanesh_wh3_main_ksl_kostaltyn_easy	prefabs/campaign/slaanesh_final_battle.bmd	terrain/campaigns/wh3_main_chaos_map_1/lighting/slaanesh.environment
wh3_main_survival_slaanesh_wh3_main_ksl_kostaltyn_hard	prefabs/campaign/slaanesh_final_battle.bmd	terrain/campaigns/wh3_main_chaos_map_1/lighting/slaanesh.environment
wh3_main_survival_slaanesh_wh3_main_nur_kugath	prefabs/campaign/slaanesh_final_battle.bmd	terrain/campaigns/wh3_main_chaos_map_1/lighting/slaanesh.environment
wh3_main_survival_slaanesh_wh3_main_nur_kugath_easy	prefabs/campaign/slaanesh_final_battle.bmd	terrain/campaigns/wh3_main_chaos_map_1/lighting/slaanesh.environment
wh3_main_survival_slaanesh_wh3_main_nur_kugath_hard	prefabs/campaign/slaanesh_final_battle.bmd	terrain/campaigns/wh3_main_chaos_map_1/lighting/slaanesh.environment
wh3_main_survival_slaanesh_wh3_main_ogr_greasus_goldtooth	prefabs/campaign/slaanesh_final_battle.bmd	terrain/campaigns/wh3_main_chaos_map_1/lighting/slaanesh.environment
wh3_main_survival_slaanesh_wh3_main_ogr_greasus_goldtooth_easy	prefabs/campaign/slaanesh_final_battle.bmd	terrain/campaigns/wh3_main_chaos_map_1/lighting/slaanesh.environment
wh3_main_survival_slaanesh_wh3_main_ogr_greasus_goldtooth_hard	prefabs/campaign/slaanesh_final_battle.bmd	terrain/campaigns/wh3_main_chaos_map_1/lighting/slaanesh.environment
wh3_main_survival_slaanesh_wh3_main_ogr_skrag_the_slaughterer	prefabs/campaign/slaanesh_final_battle.bmd	terrain/campaigns/wh3_main_chaos_map_1/lighting/slaanesh.environment
wh3_main_survival_slaanesh_wh3_main_ogr_skrag_the_slaughterer_easy	prefabs/campaign/slaanesh_final_battle.bmd	terrain/campaigns/wh3_main_chaos_map_1/lighting/slaanesh.environment
wh3_main_survival_slaanesh_wh3_main_ogr_skrag_the_slaughterer_hard	prefabs/campaign/slaanesh_final_battle.bmd	terrain/campaigns/wh3_main_chaos_map_1/lighting/slaanesh.environment
wh3_main_survival_slaanesh_wh3_main_sla_nkari	prefabs/campaign/slaanesh_final_battle.bmd	terrain/campaigns/wh3_main_chaos_map_1/lighting/slaanesh.environment
wh3_main_survival_slaanesh_wh3_main_sla_nkari_easy	prefabs/campaign/slaanesh_final_battle.bmd	terrain/campaigns/wh3_main_chaos_map_1/lighting/slaanesh.environment
wh3_main_survival_slaanesh_wh3_main_sla_nkari_hard	prefabs/campaign/slaanesh_final_battle.bmd	terrain/campaigns/wh3_main_chaos_map_1/lighting/slaanesh.environment
wh3_main_survival_slaanesh_wh3_main_tze_kairos	prefabs/campaign/slaanesh_final_battle.bmd	terrain/campaigns/wh3_main_chaos_map_1/lighting/slaanesh.environment
wh3_main_survival_slaanesh_wh3_main_tze_kairos_easy	prefabs/campaign/slaanesh_final_battle.bmd	terrain/campaigns/wh3_main_chaos_map_1/lighting/slaanesh.environment
wh3_main_survival_slaanesh_wh3_main_tze_kairos_hard	prefabs/campaign/slaanesh_final_battle.bmd	terrain/campaigns/wh3_main_chaos_map_1/lighting/slaanesh.environment
wh3_main_survival_tzeentch_wh3_main_cth_miao_ying	prefabs/campaign/tze_final_battle.bmd	terrain/campaigns/wh3_main_chaos_map_1/lighting/tzeentch.environment
wh3_main_survival_tzeentch_wh3_main_cth_miao_ying_easy	prefabs/campaign/tze_final_battle.bmd	terrain/campaigns/wh3_main_chaos_map_1/lighting/tzeentch.environment
wh3_main_survival_tzeentch_wh3_main_cth_miao_ying_hard	prefabs/campaign/tze_final_battle.bmd	terrain/campaigns/wh3_main_chaos_map_1/lighting/tzeentch.environment
wh3_main_survival_tzeentch_wh3_main_cth_zhao_ming	prefabs/campaign/tze_final_battle.bmd	terrain/campaigns/wh3_main_chaos_map_1/lighting/tzeentch.environment
wh3_main_survival_tzeentch_wh3_main_cth_zhao_ming_easy	prefabs/campaign/tze_final_battle.bmd	terrain/campaigns/wh3_main_chaos_map_1/lighting/tzeentch.environment
wh3_main_survival_tzeentch_wh3_main_cth_zhao_ming_hard	prefabs/campaign/tze_final_battle.bmd	terrain/campaigns/wh3_main_chaos_map_1/lighting/tzeentch.environment
wh3_main_survival_tzeentch_wh3_main_dae_daemon_prince	prefabs/campaign/tze_final_battle.bmd	terrain/campaigns/wh3_main_chaos_map_1/lighting/tzeentch.environment
wh3_main_survival_tzeentch_wh3_main_dae_daemon_prince_easy	prefabs/campaign/tze_final_battle.bmd	terrain/campaigns/wh3_main_chaos_map_1/lighting/tzeentch.environment
wh3_main_survival_tzeentch_wh3_main_dae_daemon_prince_hard	prefabs/campaign/tze_final_battle.bmd	terrain/campaigns/wh3_main_chaos_map_1/lighting/tzeentch.environment
wh3_main_survival_tzeentch_wh3_main_kho_skarbrand	prefabs/campaign/tze_final_battle.bmd	terrain/campaigns/wh3_main_chaos_map_1/lighting/tzeentch.environment
wh3_main_survival_tzeentch_wh3_main_kho_skarbrand_easy	prefabs/campaign/tze_final_battle.bmd	terrain/campaigns/wh3_main_chaos_map_1/lighting/tzeentch.environment
wh3_main_survival_tzeentch_wh3_main_kho_skarbrand_hard	prefabs/campaign/tze_final_battle.bmd	terrain/campaigns/wh3_main_chaos_map_1/lighting/tzeentch.environment
wh3_main_survival_tzeentch_wh3_main_ksl_boris	prefabs/campaign/tze_final_battle.bmd	terrain/campaigns/wh3_main_chaos_map_1/lighting/tzeentch.environment
wh3_main_survival_tzeentch_wh3_main_ksl_boris_easy	prefabs/campaign/tze_final_battle.bmd	terrain/campaigns/wh3_main_chaos_map_1/lighting/tzeentch.environment
wh3_main_survival_tzeentch_wh3_main_ksl_boris_hard	prefabs/campaign/tze_final_battle.bmd	terrain/campaigns/wh3_main_chaos_map_1/lighting/tzeentch.environment
wh3_main_survival_tzeentch_wh3_main_ksl_katarin	prefabs/campaign/tze_final_battle.bmd	terrain/campaigns/wh3_main_chaos_map_1/lighting/tzeentch.environment
wh3_main_survival_tzeentch_wh3_main_ksl_katarin_easy	prefabs/campaign/tze_final_battle.bmd	terrain/campaigns/wh3_main_chaos_map_1/lighting/tzeentch.environment
wh3_main_survival_tzeentch_wh3_main_ksl_katarin_hard	prefabs/campaign/tze_final_battle.bmd	terrain/campaigns/wh3_main_chaos_map_1/lighting/tzeentch.environment
wh3_main_survival_tzeentch_wh3_main_ksl_kostaltyn	prefabs/campaign/tze_final_battle.bmd	terrain/campaigns/wh3_main_chaos_map_1/lighting/tzeentch.environment
wh3_main_survival_tzeentch_wh3_main_ksl_kostaltyn_easy	prefabs/campaign/tze_final_battle.bmd	terrain/campaigns/wh3_main_chaos_map_1/lighting/tzeentch.environment
wh3_main_survival_tzeentch_wh3_main_ksl_kostaltyn_hard	prefabs/campaign/tze_final_battle.bmd	terrain/campaigns/wh3_main_chaos_map_1/lighting/tzeentch.environment
wh3_main_survival_tzeentch_wh3_main_nur_kugath	prefabs/campaign/tze_final_battle.bmd	terrain/campaigns/wh3_main_chaos_map_1/lighting/tzeentch.environment
wh3_main_survival_tzeentch_wh3_main_nur_kugath_easy	prefabs/campaign/tze_final_battle.bmd	terrain/campaigns/wh3_main_chaos_map_1/lighting/tzeentch.environment
wh3_main_survival_tzeentch_wh3_main_nur_kugath_hard	prefabs/campaign/tze_final_battle.bmd	terrain/campaigns/wh3_main_chaos_map_1/lighting/tzeentch.environment
wh3_main_survival_tzeentch_wh3_main_ogr_greasus_goldtooth	prefabs/campaign/tze_final_battle.bmd	terrain/campaigns/wh3_main_chaos_map_1/lighting/tzeentch.environment
wh3_main_survival_tzeentch_wh3_main_ogr_greasus_goldtooth_easy	prefabs/campaign/tze_final_battle.bmd	terrain/campaigns/wh3_main_chaos_map_1/lighting/tzeentch.environment
wh3_main_survival_tzeentch_wh3_main_ogr_greasus_goldtooth_hard	prefabs/campaign/tze_final_battle.bmd	terrain/campaigns/wh3_main_chaos_map_1/lighting/tzeentch.environment
wh3_main_survival_tzeentch_wh3_main_ogr_skrag_the_slaughterer	prefabs/campaign/tze_final_battle.bmd	terrain/campaigns/wh3_main_chaos_map_1/lighting/tzeentch.environment
wh3_main_survival_tzeentch_wh3_main_ogr_skrag_the_slaughterer_easy	prefabs/campaign/tze_final_battle.bmd	terrain/campaigns/wh3_main_chaos_map_1/lighting/tzeentch.environment
wh3_main_survival_tzeentch_wh3_main_ogr_skrag_the_slaughterer_hard	prefabs/campaign/tze_final_battle.bmd	terrain/campaigns/wh3_main_chaos_map_1/lighting/tzeentch.environment
wh3_main_survival_tzeentch_wh3_main_sla_nkari	prefabs/campaign/tze_final_battle.bmd	terrain/campaigns/wh3_main_chaos_map_1/lighting/tzeentch.environment
wh3_main_survival_tzeentch_wh3_main_sla_nkari_easy	prefabs/campaign/tze_final_battle.bmd	terrain/campaigns/wh3_main_chaos_map_1/lighting/tzeentch.environment
wh3_main_survival_tzeentch_wh3_main_sla_nkari_hard	prefabs/campaign/tze_final_battle.bmd	terrain/campaigns/wh3_main_chaos_map_1/lighting/tzeentch.environment
wh3_main_survival_tzeentch_wh3_main_tze_kairos	prefabs/campaign/tze_final_battle.bmd	terrain/campaigns/wh3_main_chaos_map_1/lighting/tzeentch.environment
wh3_main_survival_tzeentch_wh3_main_tze_kairos_easy	prefabs/campaign/tze_final_battle.bmd	terrain/campaigns/wh3_main_chaos_map_1/lighting/tzeentch.environment
wh3_main_survival_tzeentch_wh3_main_tze_kairos_hard	prefabs/campaign/tze_final_battle.bmd	terrain/campaigns/wh3_main_chaos_map_1/lighting/tzeentch.environment
wh3_prologue_howling_citadel	prefabs/campaign/howling_citadel_final_battle.bmd	terrain/campaigns/wh3_main_prologue_map/lighting/prologue_snow_tze.environment
wh3_survival_forge_of_souls_fe	prefabs/campaign/forge_of_souls_battle.bmd	terrain/campaigns/wh3_main_chaos_map_1/lighting/khorne.environment
wh_main_qb_grn_grimgor_ironhide_blood_forged_armour_stage_4_battle_of_high_pass	prefabs/campaign/forge_of_souls_battle.bmd	terrain/campaigns/wh3_main_chaos_map_1/lighting/khorne.environment
