character	frontend_group
#battle_set_piece_frontend_groups_to_characters_tables;0;db/battle_set_piece_frontend_groups_to_characters_tables/data__	
wh2_dlc09_qb_tmb_tretch_craventail_lucky_skullhelm_stage_5_player	wh2_dlc09_skv_tretch
wh2_dlc09_qb_tmb_arkhan_staff_of_nagash_defender_arkhan	wh2_dlc09_tmb_arkhan
wh2_dlc09_qb_tmb_arkhan_the_tomb_blade_of_arkhan_stage_3_mortuary_of_tzulaqua_defender_arkhan	wh2_dlc09_tmb_arkhan
wh2_dlc09_qb_tmb_final_battle_arkhan_player	wh2_dlc09_tmb_arkhan
wh2_dlc09_qb_tmb_final_battle_khalida_player	wh2_dlc09_tmb_khalida
wh2_dlc09_qb_tmb_khalida_venom_staff_stage_3_ash_river_player	wh2_dlc09_tmb_khalida
wh2_dlc09_qb_tmb_final_battle_khatep_player	wh2_dlc09_tmb_khatep
wh2_dlc09_qb_tmb_khatep_the_liche_staff_stage_5_pits_of_zardok_attacker_01	wh2_dlc09_tmb_khatep
wh2_dlc09_qb_tmb_final_battle_settra_player	wh2_dlc09_tmb_settra
wh2_dlc09_qb_tmb_settra_the_blessed_blade_of_ptra_stage_3_charnel_valley_attacker_01	wh2_dlc09_tmb_settra
wh2_dlc09_tmb_settra_the_crown_of_nehekhara_stage_5_pack_ice_bay_attacker	wh2_dlc09_tmb_settra
wh2_dlc09_cha_arkhan_0	wh2_dlc10_def_hellebron
wh2_dlc10_qb_def_hellebron_deathsword_and_the_cursed_blade_stage_4_altar_of_ultimate_darkness_defender_crone_hellebron_01	wh2_dlc10_def_hellebron
wh2_dlc10_qb_hef_cha_alarielle	wh2_dlc10_hef_alarielle
wh2_dlc10_qb_hef_alith_anar_the_moon_bow_stage_4_alith_anar	wh2_dlc10_hef_alith_anar
wh2_dlc11_qb_cst_aranessa_saltspite_krakens_bane_player	wh2_dlc11_cst_aranessa_saltspite
wh2_dlc11_qb_cst_cylostra_shifting_isles	wh2_dlc11_cst_cylostra
wh2_dlc11_cst_qb_noctilus_general	wh2_dlc11_cst_noctilus
wh2_dlc11_qb_def_lokhir_fellheart_helm_of_the_kraken_defender	wh2_dlc11_def_lokhir
wh2_dlc11_qb_cst_harkon_quest_for_slann_gold	wh2_dlc11_luthor_harkon
wh2_dlc12_lzd_lord_kroak_tehenhauin_01	wh2_dlc12_lzd_tehenhauin
wh2_dlc12_qb_lzd_tehenhauin_plaque_of_sotek_tehenhauin	wh2_dlc12_lzd_tehenhauin
wh2_dlc12_lzd_lord_kroak_tiktaqto	wh2_dlc12_lzd_tiktaqto
wh2_dlc12_qb_lzd_tiktaqto_mask_of_heavens_player	wh2_dlc12_lzd_tiktaqto
wh2_dlc12_skv_cha_ikit_claw_qb	wh2_dlc12_skv_ikit_claw
wh2_dlc13_emp_cha_markus_wulfhart_0_final_battle	wh2_dlc13_emp_wulfhart
wh2_dlc13_emp_wulfhart_amber_bow_stage_4_player_wulfhart	wh2_dlc13_emp_wulfhart
wh2_dlc13_lzd_gorrok_qb	wh2_dlc13_lzd_gorrok
wh2_dlc13_lzd_lord_kroak_nakai	wh2_dlc13_lzd_nakai
wh2_dlc13_lzd_nakai_qb	wh2_dlc13_lzd_nakai
wh2_dlc14_qb_brt_repanse_defend_or_conquer_crusader_repanse	wh2_dlc14_brt_repanse
wh2_dlc14_qb_brt_repanse_defend_or_conquer_guardian_repanse	wh2_dlc14_brt_repanse
wh2_dlc14_qb_brt_repanse_sword_of_lyonesse_repanse	wh2_dlc14_brt_repanse
wh2_dlc14_qb_def_malus_final_battle_def_malus	wh2_dlc14_def_malus
wh2_dlc14_qb_def_malus_warpsword_of_khaine_malus	wh2_dlc14_def_malus
wh2_dlc14_qb_skv_snikch_final_battle_skv_snikch	wh2_dlc14_skv_snikch
wh2_dlc14_qb_skv_snikch_the_cloak_of_shadows_snikch	wh2_dlc14_skv_snikch
wh_dlc15_qb_grn_grom_axe_of_grom_grn_grom	wh2_dlc15_grn_grom
wh_dlc15_qb_grn_grom_final_battle_grn_grom	wh2_dlc15_grn_grom
wh2_dlc15_qb_hef_imrik_armour_of_caledor_imrik	wh2_dlc15_hef_imrik
wh2_dlc15_qb_hef_imrik_dragon_boss_battles_stage_1_player	wh2_dlc15_hef_imrik
wh_dlc16_qb_wef_drycha_coeddil_unchained_drycha	wh2_dlc16_wef_drycha
wh2_dlc17_qb_bst_taurox_rune_tortured_axes_player_taurox	wh2_dlc17_bst_taurox
wh2_dlc17_qb_final_battle_bst_taurox_player	wh2_dlc17_bst_taurox
wh_dlc17_qb_dwf_cha_thorek_klad_brakak_dwf_thorek	wh2_dlc17_dwf_thorek
wh_dlc17_qb_dwf_cha_thorek_lost_vault_dwf_thorek	wh2_dlc17_dwf_thorek
wh2_dlc17_lzd_lord_kroak_oxyotl	wh2_dlc17_lzd_oxyotl
wh2_dlc17_qb_final_battle_lzd_oxyotl_player	wh2_dlc17_lzd_oxyotl
wh2_dlc17_qb_lzd_oxyotl_the_golden_blowpipe_of_ptoohee_player_oxyotl	wh2_dlc17_lzd_oxyotl
wh2_dlc17_qb_lzd_oxyotl_the_golden_blowpipe_of_ptoohee_player_oxyotl_stage_4b	wh2_dlc17_lzd_oxyotl
wh2_main_qb_def_malekith_circlet_of_iron_stage_3_altar_of_ultimate_darkness_defender_malekith	wh2_main_def_malekith
wh2_main_qb_def_malekith_destroyer_stage_3_vauls_anvil_attacker_malekith	wh2_main_def_malekith
wh2_main_qb_def_malekith_supreme_spellshield_stage_3_mosquito_swamps_attacker_malekith	wh2_main_def_malekith
wh2_main_qb_def_morathi_heartrender_and_the_darksword_stage_6_attacker_morathi	wh2_main_def_morathi
wh2_main_qb_hef_teclis_sword_of_teclis_stage_3_vauls_anvil_attacker_teclis	wh2_main_hef_teclis
wh2_main_qb_hef_teclis_war_crown_of_saphery_stage_3_caverns_of_the_great_defender_teclis	wh2_main_hef_teclis
wh2_main_qb_hef_tyrion_dragon_armour_of_aenarion_stage_4_vauls_anvil_defender_tyrion	wh2_main_hef_tyrion
wh2_main_qb_hef_tyrion_sunfang_stage_4_tower_of_hoeth_attacker_tyrion	wh2_main_hef_tyrion
wh2_dlc12_lzd_lord_kroak_kroqgar	wh2_main_lzd_kroq_gar
wh2_main_qb_lzd_kroqgar_hand_of_gods_stage_3_fallen_gates_attacker	wh2_main_lzd_kroq_gar
wh2_main_qb_lzd_kroqgar_revered_spear_of_tlanxla_stage_3_mosquito_swamps_attacker_kroqgar	wh2_main_lzd_kroq_gar
wh2_dlc12_lzd_lord_kroak_mazdamundi	wh2_main_lzd_lord_mazdamundi
wh2_main_qb_lzd_mazdamundi_cobra_mace_of_mazdamundi_stage_3_isle_of_the_crimson_skull_attacker_mazdamundi	wh2_main_lzd_lord_mazdamundi
wh2_main_qb_lzd_mazdamundi_sunburst_standard_of_hexoatl_stage_4_fallen_gates_defender_mazdamundi	wh2_main_lzd_lord_mazdamundi
wh2_main_qb_skv_skrolk_rod_of_corruption_stage_3_isle_of_the_crimson_skull_defender_lord_skrolk	wh2_main_skv_lord_skrolk
wh2_main_qb_skv_skrolk_the_liber_bubonicus_stage_3_mortuary_of_tzulaqua_defender_lord_skrolk	wh2_main_skv_lord_skrolk
wh2_main_qb_skv_queek_dwarf_gouger_stage_4_gouger_gully_defender_queek	wh2_main_skv_queek_headtaker
wh2_main_qb_skv_queek_headtaker_warp_shard_armour_stage_6_warp_shard_caverns_attacker_queek	wh2_main_skv_queek_headtaker
wh2_twa03_qb_def_rakarth_whip_of_agony_player_rakarth	wh2_twa03_def_rakarth
wh3_dlc20_qb_chs_azazel_daemonblade_player_azazel	wh3_dlc20_chs_azazel
wh3_dlc20_survival_chs_altar_of_battle_enemy_azazel	wh3_dlc20_chs_azazel
wh3_dlc20_qb_chs_festus_pestilent_potions_player_festus	wh3_dlc20_chs_festus
wh3_dlc20_survival_chs_altar_of_battle_enemy_festus	wh3_dlc20_chs_festus
wh3_dlc20_qb_chs_valkia_the_spear_slaupnir_player_valkia	wh3_dlc20_chs_valkia
wh3_dlc20_survival_chs_altar_of_battle_enemy_valkia	wh3_dlc20_chs_valkia
wh3_dlc20_qb_chs_vilitch_vessel_of_chaos_player_vilitch	wh3_dlc20_chs_vilitch
wh3_dlc20_survival_chs_altar_of_battle_enemy_vilitch	wh3_dlc20_chs_vilitch
wh3_dlc23_chd_cha_astragoth_ironhand_qb	wh3_dlc23_chd_astragoth
wh3_dlc23_chd_cha_astragoth_ironhand_qb_final_battle	wh3_dlc23_chd_astragoth
wh3_dlc23_qb_chd_astragoth_black_hammer_of_hashut_player_atragoth	wh3_dlc23_chd_astragoth
wh3_dlc23_chd_cha_drazhoath_the_ashen_final_battle	wh3_dlc23_chd_drazhoath
wh3_dlc23_chd_cha_drazhoath_the_ashen_qb	wh3_dlc23_chd_drazhoath
wh3_dlc23_qb_chd_drazhoath_hellshard_amulet_player_drazhoath	wh3_dlc23_chd_drazhoath
wh3_dlc23_chd_cha_zhatan_the_black_qb	wh3_dlc23_chd_zhatan
wh3_dlc23_chd_cha_zhatan_the_black_qb_final_battle	wh3_dlc23_chd_zhatan
wh3_dlc23_qb_chd_zhatan_chaos_runeshield_player_zhatan	wh3_dlc23_chd_zhatan
wh3_main_qb_kho_skarbrand_slaughter_and_carnage_player	wh3_main_kho_skarbrand
wh3_main_qb_ksl_katarin_boris_unlock_player	wh3_main_ksl_katarin
wh3_main_qb_ksl_katarin_crystal_cloak_player	wh3_main_ksl_katarin
wh3_main_qb_ksl_kostaltyn_boris_unlock_player	wh3_main_ksl_kostaltyn
wh3_main_qb_ksl_kostaltyn_burning_brazier_player	wh3_main_ksl_kostaltyn
wh3_main_qb_nrg_kugath_necrotic_missiles_player	wh3_main_nur_kugath
wh3_main_qb_ogr_greasus_overtyrants_crown_player	wh3_main_ogr_greasus
wh3_main_qb_ogr_skrag_cauldron_of_the_great_maw_player	wh3_main_ogr_skrag
wh3_main_qb_sla_nkari_sword_player_01	wh3_main_sla_nkari
wh3_main_qb_tze_kairos_staff_of_tomorrow_player	wh3_main_tze_kairos
wh3_prologue_qa_yuri_barkov_brazen_altar	wh3_prologue_yuri_barkov
wh3_prologue_yuri_barkov_howling_citadel	wh3_prologue_yuri_barkov
wh3_prologue_yuri_barkov_ice_witch_rescue	wh3_prologue_yuri_barkov
wh3_main_tut_scenario_player_cav_player	wh3_tut_scenario
wh_dlc01_qb_chs_archaon_armour_of_morkar_stage_3_player	wh_dlc01_chs_archaon
wh_dlc01_qb_chs_archaon_crown_of_command_stage_2_player	wh_dlc01_chs_archaon
wh_dlc01_qb_chs_archaon_eye_of_sheerian_stage_3_player	wh_dlc01_chs_archaon
wh_dlc01_qb_chs_archaon_slayer_of_kings_stage_3_player	wh_dlc01_chs_archaon
wh_dlc01_qb_chs_kholek_suneater_starcrusher_stage_3_player	wh_dlc01_chs_kholek
wh_dlc01_qb_chs_prince_sigvald_auric_armour_stage_3_player	wh_dlc01_chs_sigvald
wh_dlc01_qb_chs_prince_sigvald_sliverslash_stage_4_player	wh_dlc01_chs_sigvald
wh_dlc03_qb_bst_khazrak_one_eye_scourge_stage_4_player_grandcampaign	wh_dlc03_bst_khazrak
wh_dlc03_qb_bst_khazrak_one_eye_the_dark_mail_stage_5_player_grandcampaign	wh_dlc03_bst_khazrak
wh_dlc03_qb_bst_the_final_battle_player	wh_dlc03_bst_khazrak
wh_dlc03_qb_bst_malagor_the_dark_omen_the_icons_of_vilification_stage_5_player_grandcampaign	wh_dlc03_bst_malagor
wh_dlc04_qb_emp_volkmar_the_grim_jade_griffon_stage_4_player	wh_dlc04_emp_volkmar
wh_dlc04_qb_emp_volkmar_the_grim_staff_of_command_stage_4_player	wh_dlc04_emp_volkmar
wh_dlc04_qb_vmp_helman_ghorst_liber_noctus_stage_4_player	wh_dlc04_vmp_helman
wh_dlc04_qb_vmp_vlad_von_carstein_the_von_carstein_ring_stage_4_player	wh_dlc04_vmp_vlad
wh_dlc04_qb_vmp_vlad_von_cartein_blood_drinker_stage_4_player	wh_dlc04_vmp_vlad
wh_dlc05_qb_bst_morghur_stave_of_ruinous_corruption_stage_4_player	wh_dlc05_bst_morghur
wh_dlc05_qb_wef_durthu_daiths_sword_stage_4_player	wh_dlc05_wef_durthu
wh_dlc05_qb_wef_grand_defense_of_the_oak_player	wh_dlc05_wef_orion
wh_dlc05_qb_wef_mini_silver_spire_player	wh_dlc05_wef_orion
wh_dlc05_qb_wef_orion_the_cloak_of_isha_stage_3_player	wh_dlc05_wef_orion
wh_dlc05_qb_wef_orion_the_horn_of_the_wild_stage_3_player	wh_dlc05_wef_orion
wh_dlc05_qb_wef_orion_the_spear_of_kurnous_stage_3_player	wh_dlc05_wef_orion
wh_dlc06_qb_dwf_belegar_ironhammer_hammer_of_angrund_stage_4_player	wh_dlc06_dwf_belegar
wh_dlc06_qb_dwf_belegar_ironhammer_shield_of_defiance_stage_3_player	wh_dlc06_dwf_belegar
wh_dlc06_qb_grn_skarsnik_skarsniks_prodder_stage_5_player	wh_dlc06_grn_skarsnik
wh_dlc06_grn_wurrzag_da_great_green_prophet_squiggly_beast_stage_3_player	wh_dlc06_grn_wurrzag
wh_dlc06_qb_grn_wurrzag_da_great_green_prophet_baleful_mask_stage_4_player	wh_dlc06_grn_wurrzag
wh_dlc06_qb_grn_wurrzag_da_great_green_prophet_bonewood_staff_stage_3_player	wh_dlc06_grn_wurrzag
wh_dlc07_qb_brt_alberic_trident_of_manann_stage_8_player	wh_dlc07_brt_alberic
wh_dlc07_qb_brt_fay_enchantress_chalice_of_potions_stage_6_player	wh_dlc07_brt_fay_enchantress
wh_dlc07_brt_louen_leoncoeur_sword_of_couronne_player	wh_dlc07_brt_king_louen_leoncoeur
wh_dlc07_qb_brt_louen_errantry_war_stage_1_player	wh_dlc07_brt_king_louen_leoncoeur
wh_dlc08_qb_nor_cha_throgg_player_wintertooth_crown	wh_dlc08_nor_throgg
wh_dlc08_qb_nor_throgg_final_battle	wh_dlc08_nor_throgg
wh_dlc08_qb_nor_throgg_monster_hunt_general	wh_dlc08_nor_throgg
wh_dlc08_qb_nor_cha_wulfrik_the_wanderer_0_player_sword_of_torgald	wh_dlc08_nor_wulfrik
wh_dlc08_qb_nor_wulfrik_monster_hunt_general	wh_dlc08_nor_wulfrik
wh_dlc15_qb_hef_eltharion_final_battle_hef_eltharion	wh_dlc15_hef_eltharion
wh_dlc15_qb_hef_eltharion_talisman_of_hoeth_stage_3_player_eltharion	wh_dlc15_hef_eltharion
wh2_dlc16_qb_skv_throt_final_battle_skv_throt	wh_dlc16_skv_throt
wh2_dlc16_qb_skv_throt_whip_of_domination_skv_throt	wh_dlc16_skv_throt
wh2_dlc16_qb_wef_sisters_dragon_stage_3_witch_wood_hollow_attacker_sisters_of_twilight_01	wh_dlc16_wef_sisters
wh2_dlc16_qb_wef_sisters_final_battle_wef_sisters	wh_dlc16_wef_sisters
wh_main_qb_dwf_thorgrim_grudgebearer_armour_of_skaldour_stage_4_player	wh_main_dwf_thorgrim
wh_main_qb_dwf_thorgrim_grudgebearer_axe_of_grimnir_stage_3_player	wh_main_dwf_thorgrim
wh_main_qb_dwf_thorgrim_grudgebearer_book_of_grudges_stage_3_player	wh_main_dwf_thorgrim
wh_main_qb_dwf_thorgrim_grudgebearer_dragon_crown_of_karaz_stage_3_black_fire_pass_player_1_general	wh_main_dwf_thorgrim
wh_main_qb_dwf_thorgrim_grudgebearer_intro_subterranean_player	wh_main_dwf_thorgrim
wh_main_qb_dwf_ungrim_ironfist_axe_of_dargo_stage_4_player	wh_main_dwf_ungrim
wh_main_qb_dwf_ungrim_ironfist_dragon_cloak_of_fyrskar_stage_4_player	wh_main_dwf_ungrim
wh_main_qb_dwf_ungrim_ironfist_slayer_crown_stage_5_player	wh_main_dwf_ungrim
wh_main_qb_emp_balthasar_gelt_amulet_of_sea_gold_stage_4_player	wh_main_emp_balthasar
wh_main_qb_emp_balthasar_gelt_cloak_of_molten_metal_stage_5_player	wh_main_emp_balthasar
wh_main_qb_emp_balthasar_gelt_staff_of_volans_stage_3_player	wh_main_emp_balthasar
wh_main_qb_emp_karl_franz_ghal_maraz_stage_4_black_fire_pass_player_1_general	wh_main_emp_karl
wh_main_qb_emp_karl_franz_intro_battle_of_bloodpine_woods_player	wh_main_emp_karl
wh_main_qb_emp_karl_franz_reikland_runefang_stage_3_player	wh_main_emp_karl
wh_main_qb_emp_karl_franz_silver_seal_stage_3_player	wh_main_emp_karl
wh_main_qb_grn_azhag_the_slaughterer_azhags_ard_armour_stage_4_player	wh_main_grn_azhag
wh_main_qb_grn_azhag_the_slaughterer_crown_of_sorcery_stage_3_player	wh_main_grn_azhag
wh_main_qb_grn_azhag_the_slaughterer_slaggas_slashas_stage_4_player	wh_main_grn_azhag
wh_main_qb_grn_grimgor_ironhide_blood_forged_armour_stage_4_player	wh_main_grn_grimgor
wh_main_qb_grn_grimgor_ironhide_gitsnik_stage_4_black_fire_pass_player_1_general	wh_main_grn_grimgor
wh_main_qb_grn_grimgor_ironhide_intro_subterranean_player	wh_main_grn_grimgor
wh_main_qb_vmp_heinrich_kemmler_chaos_tomb_blade_stage_4_player	wh_main_vmp_heinrich
wh_main_qb_vmp_heinrich_kemmler_cloak_of_mists_stage_3_player	wh_main_vmp_heinrich
wh_main_qb_vmp_heinrich_kemmler_skull_staff_stage_3_player	wh_main_vmp_heinrich
wh_main_qb_vmp_mannfred_von_carstein_armour_of_templehof_stage_6_player	wh_main_vmp_mannfred
wh_main_qb_vmp_mannfred_von_carstein_intro_battle_of_hel_fenn_player	wh_main_vmp_mannfred
wh_main_qb_vmp_mannfred_von_carstein_sword_of_unholy_power_stage_4_player	wh_main_vmp_mannfred
wh_pro01_qb_dwf_grombrindal_armour_of_glimril_stage_3_player	wh_pro01_dwf_grombrindal
wh_pro01_qb_dwf_grombrindal_rune_axe_of_grimnir_stage_3_golden_monolith_player	wh_pro01_dwf_grombrindal
wh_pro01_qb_dwf_grombrindal_rune_cloak_of_valaya_stage_3_todtheim_player	wh_pro01_dwf_grombrindal
wh_pro01_qb_dwf_grombrindal_rune_helm_of_zhufbar_stage_4_player	wh_pro01_dwf_grombrindal
wh_pro02_qb_vmp_isabella_von_carstein_blood_chalice_of_bathori_stage_5_player	wh_pro02_vmp_isabella
